Abbott	Abbott, T.K. Catalogue of fifteenth-century books in the Library of Trinity College, Dublin and in Marsh's Library, Dublin, with a few from other collections. Dublin, 1905.
Accurti(1930)	Accurti, Thomas. Editiones saeculi XV pleraeque bibliographis ignotae. Florentiae, 1930.
Accurti(1936)	Accurti, Thomas. Aliae editiones saeculi XV pleraeque nondum descriptae. Florentiae, 1936.
Adams	Adams, H.M. Catalogue of books printed on the continent of Europe, 1501-1600, in Cambridge libraries. 2 vols. Cambridge, 1967.
Adler	Adler, Israel. 'Les incunables hébraïques de la Bibliothèque Nationale'. Le livre hébraïque: incunables, publications israéliennes. Exposition, Paris, 1962, pp. 69-106.
Ageno	Ageno, F. Librorum saec. XV impressorum qui in publica Ticinensi Bibliotheca adservantur catalogus. Florentiae, 1954. (Biblioteca di bibliografia italiana, 29).
AGB	Archiv für Geschichte des Buchwesens.
AGM	Archiv für Geschichte der Medizin.
Alberts(Anshelm)	Alberts, Hildegard. 'Reuchlins Drucker, Thomas Anshelm'. Johannes Reuchlin 1455-1522: Festgabe ... zur 400. Wiederkehr seines Geburtstages, Pforzheim, 1955, pp.205-65.
Altmann(Brandis)	Altmann, Ursula. Die Leistungen der Drucker mit Namen Brandis im Rahmen der Buchgeschichte des 15.Jahrhunderts. [Dissertation. Unpublished MS, Berlin 1974] Published by SBPK Berlin, Gesamtkatalog der Wiegendrucke, 2005, see: http://edoc.hu-berlin.de/dissertationen/altmann-ursula-1974-12-18/PDF/Altmann.pdf
Altmann(Frisner)	Altmann, Ursula. 'Andreas Frisner, der Drucker des Capotius und Martin Landsberg'. Johannes Gutenberg: Regionale Aspekte des frühen Buchdrucks: Vorträge der Internationalen Konferenz zum 550. Jubiläum der Buchdruckerkunst am 26. und 27. Juni 1990 in Berlin, Wiesbaden, 1993, pp. 203-17 (Beiträge aus der Staatsbibliothek zu Berlin, Preußischer Kulturbesitz, Bd.1).
AmBCat	Pollard, Alfred W. Catalogue of books … from the presses of the first printers, collected by Rush C. Hawkins and deposited in the Annmary Brown Memorial at Providence, Rhode Island. Oxford, 1910.
Amelung, Frühdruck	Amelung, Peter. Der Frühdruck im deutschen Südwesten, 1473-1500. Bd. 1 [etc]. Stuttgart, 1979- [in progress].
Amelung, Hellinga Festschrift	Amelung, Peter. 'Die niederländischen Inkunabeln der Württembergischen Landesbibliothek in Stuttgart'. Hellinga-Festschrift: 43 studies in bibliography presented to Prof. Dr. Wytze Hellinga … 1978, Amsterdam, 1980, pp.1-27.
Amelung(Reutlingen)	Amelung, Peter. Katalog der Inkunabeln der Stadtbücherei Reutlingen. Reutlingen, 1976.
Amzalak	Amzalak, Moses Bensabat. A tipografia hebraica em Portugal no século quinze. Coimbra, 1922.
Anselmo	Anselmo, Artur. Origens da imprensa em Portugal. Lisboa, 1981.
Aquilon	Aquilon, Pierre. Catalogues régionaux des incunables des Bibliothèques publiques de France. Vol.X: Région Centre. Paris, 1991.
Arnoult	Arnoult, Jean-Marie. Catalogues régionaux des incunables des Bibliothèques publiques de France. Vol.I: Bibliothèques de la Région Champagne-Ardenne. Bordeaux, 1979.
Audiffredi	Audiffredi, Giovanni Battista. Catalogus historico-criticus Romanarum editionum saeculi XV. Romae, 1783.
Audiat	Audiat, Louis. 'Évêché et Chapitre de Saintes'. Archives Historiques de la Saintonage et de l'Aunis 10 (1882), pp. 21-142.
Audin	Audin de Rians, S.L.G.E. [Bibliography of the writings of Savonarola], in Trattato di frate Ieronimo Savonarola circa il reggimento e governo della città di Firenze. Firenze, 1847.
Baer, Kat.585	Joseph Baer & Co. Incunabula xylographica et typographica 1455-1500 (Lagerkatalog 585). Frankfurt a.M., 1910.
Badalić(Croatia)	Badalić, Josip. Inkunabule u Narodnoj Republici Hrvatskoj (Incunabula quae in Populari Republica Croatio asservantur). Zagreb, 1952.
Balivet(Istanbul)	Balivet, Michel, Havva Kıvırcık and Nicolas Vatin. 'Les incunables de la Bibliothèque des Musées Archéologiques d'Istanbul'. Gb Jb 1987, pp. 317-23.
Ballard	Ballard, James F. A catalogue of the medieval and renaissance manuscripts and incunabula in the Boston Medical Library. Boston, 1944.
Balsamo	Balsamo, L. Giovann'Angelo Scinzenzeler tipografo in Milano (1500-1526). Firenze, 1959. (Biblioteca bibliografica italica, 20).
Barini	Barini, G.	Cantari cavallereschi dei secoli XV e XVI. Bologna, 1905.
Baroncelli	Baroncelli, U. Catalogo degli incunabuli della Biblioteca Ugo da Como di Lonato. Firenze, 1953. (Biblioteca di bibliografia italiana, 25).
Baroncelli, Inc. Quer.	Baroncelli, U. Gli incunabuli della Biblioteca Queriniana di Brescia. Brescia, 1970.
Baudrier	Baudrier, H.L. Bibliographie lyonnaise: recherches sur les imprimeurs, libraires, relieurs et fondeurs de lettres de Lyon au XVIe siècle. Lyon, Paris, 1895-1950.
Baurmeister, Viandier.	Ursula Baurmeister. 'À propos de Taillevent, maître queux de Charles V et de Charles VI. Les éditions du Viandier au xve siècle'. Bulletin du bibliophile 2001 pp.372-77.
BAVI	Sheehan, William J. Bibliothecae Apostolicae Vaticanae incunabula. 4 vols. Città del Vaticano, 1997 (Studi e testi 380-383).
BBFN Inc	Bio-bibliographia franciscana neerlandica ante saeculum XVI. II: L. Mees. Pars bibliographica, Incunabula. Nieuwkoop, 1974.
Beattie(1)	Beattie, W. 'Supplement to the hand-list of incunabula in the National Library of Scotland'. Edinburgh Bibliographical Society Transactions 2 (1944) pp.151-230.
Beattie(2)	Beattie, W. 'Second supplement … '. Edinburgh Bibliographical Society Transactions 2 (1946) pp.331-44.
Bechstein(Museum)	Deutsches Museum für Geschichte, Literatur, Kunst und Altertumskunde, ed. Ludwig Bechstein. Vol. 1-2. Jena, 1842-43.
Beck	Beck, Sigisbert. Katalog der Inkunabeln in der Stiftsbibliothek Engelberg. St. Ottilien, 1985. (Studien und Mitteilungen zur Geschichte des Benediktiner-Ordens, 27. Ergänzungsband).
Beltrami	Beltrami, R. 'Incunabuli di biblioteche e archivi novaresi'. Bollettino della sezione di Novara della R. Deputazione subalpina di storia patria 31 (1937) and 33 (1939).
Benziger(Einsiedeln)	Benziger, Karl J. Geschichte des Buchgewerbes im fürstl. Benidiktinerstifte U.L.F. von Einsiedeln. Einsiedeln, 1912.
Benziger(Riederer)	Benziger, Karl J. 'Inkunabeldrucke der Friedrich Riedererschen Offizin in Freiburg i.Br.' ZfB31 (1914), pp. 108-13.
Benzing(Aschaffenburg)	Benzing, Josef. Die Frühdrucke der Hofbibliothek Aschaffenburg bis zum Jahre 1550. Aschaffenburg, 1968. (Veröffentlichungen des Geschichts- und Kunstvereins Aschaffenburg e.V., 11).
Benzing(Strasbourg)	Benzing, Josef. Bibliographie strasbourgeoise. Baden-Baden, 1981. (Bibliotheca bibliographica aureliana, 80).
Bernoulli	Bernoulli, Carl Christoph. 'Die Incunabeln des Basler Staatsarchivs'. Basler Zeitschrift für Geschichte und Altertumskunde, 9 (1910), pp.1-35.
Bersano Begey	Bersano Begey, M. 'Gli incunabuli della Biblioteca del Grande Séminaire'. La valle d'Aosta: relazioni e communicazioni al XXXI Congresso storico subalpino, Aosta 9-11 sett. 1956, Cuneo, 1959, pp.965-75.
Bertram(Bielefeld)	Bertram, Theodor. Beschreibung der Inkunabeln, die sich in den Bibliotheken des Gymnasiums und der Altstädter Kirche zu Bielefeld befinden. Leipzig, 1906. (Beilage zu dem Proramm des Gymnasiums und Realgymnasiums zu Bielefeld Ostern 1906).
BHL	Bibliotheca hagiographica latina antiquae et mediae aetatis. 3 vols. Bruxelles, 1898-1911.
BHM	Lambert, Bernard. Bibiotheca Hieronymiana manuscripta. Vol. 1-4. Steenbrugge, 1969-1972. (Instrumenta patristica. 4)
Bianca(Messina)	Bianca, Concetta. Stampa cultura e società a Messina alla fine del Quattrocento. 2 vols. Palermo, 1988.
Bibl Belg	Bibliotheca Belgica: bibliographie générale des Pays-Bas. 7 vols. Bruxelles, 1964-75.
Bird	Bird, D.T. A catalogue of sixteenth-century medical books in Edinburgh libraries. Edinburgh, 1982.
Bloomfield	Bloomfield, Morton W. Incipits of Latin works on the virtues and vices, 1100-1500 A.D. Cambridge (Mass.), 1979.
BMC	Catalogue of books printed in the XVth century now in the British Museum [British Library]. 13 parts. London, 't Goy-Houten, 1963-2007. (Pts I-IX reproduced from the working copies of the original edition (London, 1908-62) annotated at the Museum).
BMC(Dut)	Short-title catalogue of books printed in the Netherlands and Belgium and of Dutch and Flemish books printed in other countries from 1470 to 1600 now in the British Museum. London, 1965.
BMC(Fr)	Short-title catalogue of books printed in France and of French books printed in other countries from 1470 to 1600 now in the British Museum. London, 1924. (Supplement. London, 1986.)
BMC(Ger)	Short-title catalogue of books printed in the German-speaking countries and German books printed in other countries from 1455 to 1600 now in the British Museum. London, 1962. (Supplement. London, 1990.)
BMC(It)	Short-title catalogue of books printed in Italy and of Italian books printed in other countries from 1465 to 1600 now in the British Museum. London, 1958. (Supplement. London, 1986.)
BMC(Sp)	Catalogue of books printed in Spain and of Spanish books printed elsewhere in Europe before 1601 now in the British Library. 2nd edition. London, 1989.
Bobrova	Bobrova, E.I. Akademiya Nauk SSSR: Katalog inkunabulov. Moskva, 1963.
Bod-Inc	A catalogue of books printed in the fifteenth century now in the Bodleian Library. 6 vols. Oxford, 2005.
Bodemann	Bodemann, Eduard. Xylographische und typographische Incunabeln der Königlichen Öffentlichen Bibliothek zu Hannover. Hannover, 1866.
Bodmer	Büchler-Mattmann, Helene. Inkunabeln der Bodmeriana: Katalog. Cologny-Genève, 1976.
Boh(Breviere)	Bohatta, Hanns. Bibliographie der Breviere, 1501-1850. Leipzig, 1937.
Boh(LB)	Bohatta, Hanns. Liturgische Bibliographie des XV. Jahrhunderts. Wien, 1911.
Boh(Parma)	Bohatta, Hanns. Katalog der liturgischen Drucke des XV. und XVI. Jahrhunderts in der Herzogl. Parma'schen Bibliothek in Schwarzau. 2. Teil. Wien, 1909.
Boh(1924)	Bohatta, Hanns. Bibliographie der livres d'heures … (2nd edition). Wien, 1924.
BOOCT	Bibliography of old Catalan texts. Compiled by Beatrice Jorgensen Concheff. Madison, 1985.
Borchling & Claussen	Borchling, Conrad and Claussen, Bruno. Niederdeutsche Bibliographie: Gesamtverzeichnis der niederdeutschen Drucke bis zum Jahre 1800. 3 Bde. Neumünster, 1931-57.
Borm	Borm, Wolfgang. Incunabula Guelferbytana: Blockbücher und Wiegendrucke der Herzog August Bibliothek Wolfenbüttel. Wiesbaden, 1990.
Bornschlegel	Bornschlegel, Franz A. 'Etappen der Schriftentwicklung im Augsburger Buchdruck von Günter Zainer bis Johann Schönsperger d.Ä.'. Augsburger Buchdruck und Verlagswesen: von den Anfängen bis zur Gegenwart, Wiesbaden, 1997, pp. 153-72.
Boselli	Boselli, Antonio. 'Incunabuli della R. Biblioteca Universitaria di Bologna non segnalati dal Caronti e dal Frati'. Accademie e Biblioteche d'Italia 12 (1938) pp.154-66.
Bošnjak	Bošnjak, M. A study of slavic incunabula. Zagreb, 1968.
Bourdillon	Bourdillon, F.W. The early editions of the Roman de la Rose. London, 1906. (Illustrated monographs issued by the Bibliographical Society, XIV).
Bradshaw	Bradshaw, Henry. 'The printer of Historia S. Albani'. Memorandum 1 (February 1868). (Reprinted in: Collected papers, Cambridge, 1889, pp.149-63.)
Brednich	Brednich, Rolf Wilhelm. Die Liedpublizistik im Flugblatt des 15. bis 17. Jahrhunderts. 2 vols. Baden-Baden, 1974/1975. (Bibliotheca bibliographica aureliana LV, LX.)
Breitenbruch	Breitenbruch, Bernd. Die Inkunabeln der Stadtbibliothek Ulm. Weissenhorn, [1987].
Bresson	Bresson, Odette. Catalogue du fonds hispanique ancien (1492-1808) de la Bibliothèque Sainte-Geneviève de Paris. Paris, 1994.
Broszinski(Kassel)	Broszinski, Hartmut. 'Die Inkunabeln der Gesamthochschul-Bibliothek Kassel Landesbibliothek und Murhardsche Bibliothek der Stadt Kassel. Katalog'. Hessisches Jahrbuch für Landesgeschichte 36 (1986), pp. 69-101.
Bruckner	Bruckner, Ursula. 'Wenzel Faber von Budweis oder Johannes Virdung?' Beiträge zur Inkunabelkunde, Dritte Folge 4 (1969) pp. 123-40.
Brunet	Brunet, Jacques-Charles. Manuel du libraire et de l'amateur de livres. 6 vols. & supplements. Paris, 1860-80.
Bruns-Lohmeier	Bruns, Alken and Dieter Lohmeier. Die Lübecker Buchdrucker im 15. und 16. Jahrhundert: Buchdruck für den Ostseeraum. Heide i.H., 1994.
Brussels exhib.1973, cat.	De vijfhonderdste verjaring van de boekdrukkunst in de Nederlanden. Le cinquième centenaire de l'imprimerie dans les anciens Pays-Bas. Brussel, 1973.
BSA	Bibliographical Society of America. The Papers. Vol.1 1904/07- [in progress].
BSB-Ink	Bayerische Staatsbibliothek Inkunabelkatalog. Bd. 1-6. Wiesbaden, 1988-2005.
Bücherschätze in Regensburg	Bücherschätze in Regensburg: frühe Drucke aus den Beständen der Staatlichen Bibliothek. Katalog zu Ausstellung 8.2.-2.3.1996. Regensburg, 1996.
Bühler(Doctrinale)	Bühler, Curt F. 'New Coster fragments of the Doctrinale'. Gb Jb 1938 pp.59-68.
Bühler(P)	Bühler, Curt F. 'The 15th-century editions of Petrarch's Historia Griseldis'. The Library Quarterly 15 (1945) pp.231-36.
Buffévent	Buffévent, Béatrix de. Catalogues régionaux des incunables des Bibliothèques publiques de France. Vol. VIII: Bibliothèques de la Région Ile-de-France. Paris, 1993.
Burger	Burger, Konrad. The printers and publishers of the XVth century with lists of their works. London, 1902.
Burger(Buchhändleran)	Burger, Konrad. Buchhändleranzeigen des 15. Jahrhunderts. Leipzig, 1907.
Burger(MG&IT)	Burger, Konrad. Monumenta Germaniae et Italiae typographica: deutsche und italienische Inkunabeln in getreuen Nachbildungen. Berlin, [1892]-1916.
But	Butler, Pierce. A check-list of fifteenth century books in the Newberry Library and in other libraries of Chicago. Chicago, 1933.
C	Copinger, W.A. Supplement to Hain's Repertorium bibliographicum, Part II. 2 vols. & Addenda. London, 1898 & 1902.
Camerini, Giunti	Camerini, Paolo. Annali dei Giunti. Vol.I. Venezia. Firenze, 1962-63. (Biblioteca bibliografica italica, 26, 28).
Camp	Campbell, M.F.A.G. Annales de la typographie néerlandaise au XVe siècle. La Haye, 1874. Numbers in brackets are from the 10th supplement: L. and W. Hellinga. 'Additions and notes to Campbell's Annales and GW'. Beiträge zur Inkunabelkunde, Dritte Folge 1 (1965) pp.76-86.
Camp(I)-(IV)	Campbell, M.F.A.G. Annales … , 1er-4e suppléments. La Haye, 1878-90.
Camp(XII)-(XIII)	Thienen, G. van. Campbell, M.F.A.G. Annales … . Additions … [in preparation].
Camp-Kron	Kronenberg, M.E. Campbell's Annales de la typographie néerlandaise au XVe siècle: contributions to a new edition. I) Additions. II) Losses, doubtful cases, notes. The Hague, 1956.
Camp-KronM	Kronenberg, M.E. 'More contributions and notes to a new Campbell edition'. Het Boek 36 (1964) pp.129-39.
Campbell(Maps)	Campbell, Tony. The earliest printed maps 1472-1500. London, 1987.
Caronti	Caronti, A. Gli incunabuli della Biblioteca Universitaria di Bologna. Bologna, 1889.
Cassuto	Cassuto, Umberto. 'Incunabuli ebraici a Firenze'. La Bibliofilia 12 (1910/11) pp.349-56, 464-72; 13 (1911/12) pp.222-30, 384-94. (Reprinted Firenze, 1912.)
Castan(Besançon)	Castan, Auguste. Catalogue des incunables de la Bibliothèque Publique de Besançon. Besançon, 1893.
Chap	Osborne, Lucy Eugenia. The Chapin Library, Williams College. A short-title list. Portland (Maine), 1939.
Chatelain	Chatelain, E. 'Catalogue des incunables de la bibliothèque de l'Université de Paris'. [I] Revue des bibliothèques 12 (1902) pp.121-272. ([Supplement] Revue des bibliothèques 15 (1905) pp.224-45).
Chawner	Chawner, G. A list of the incunabula in the library of King's College, Cambridge. Cambridge, 1908.
Chiodi	Chiodi, L. Indice degli incunabuli della Biblioteca Civica di Bergamo. Bergamo, 1966.
Christie	Catalogue of the Christie collection … bequeathed to … the University of Manchester. Manchester, 1915.
Church	Cole, George Watson. A catalogue of books relating to the discovery … of … America, forming a part of the library of E. D. Church. Volume I, 1482-1590. New York, 1907.
CIBN	Bibliothèque Nationale. Catalogue des incunables. T. I fasc 1-3 (Xylographes, A-D); T. II (H-Z). Paris, 1981-2006.
C(Im)	Copinger, W.A. Hand list of … the largest collection in the world of editions of 'The Imitation' of Thomas à Kempis. Privately printed, [1908].
Cioni, Poesia	Cioni, Alfredo. La poesia religiosa. Firenze, 1963. (Biblioteca bibliografica italica, 30).
Cioni, Rappr.	Cioni, Alfredo. Bibliografia delle Sacre Rappresentazioni. Firenze, 1961. (Biblioteca bibliografica italica, 22).
Cioni, Unici Cors.	Cioni, Alfredo. Esemplari unici di edizioni quattrocentine della Sezione Corsiniana. Roma, 1962.
C(IVir)	Copinger, W.A. 'Incunabula Virgiliana'. Transactions of the Bibliographical Society 2 (1893-94) pp.123-226.
Cl	Claudin, Anatole. Histoire de l'imprimerie en France au XVe et au XVIe siècle. 4 vols. Paris, 1900-14. Tables alphabétiques (rédigées par P. Lacombe). Paris, 1915, repr. Nendeln, 1971
Cl(FPPr)	Claudin, Anatole. The first Paris press. An account of the books printed for G. Fichet and J. Heynlin in the Sorbonne, 1470-72. London, 1898. (Illustrated monographs issued by the Bibliographical Society, VI).
Cl(Poit)	Claudin, Anatole. Origines et débuts de l'imprimerie à Poitiers: bibliographie des premiers livres imprimés dans cette ville. Paris, 1897.
Claes	Bibliographisches Verzeichnis der deutschen Vokabulare und Wörterbücher, gedruckt bis 1600. Hildesheim, New York, 1977.
Cockshaw	Cockshaw, Pierre. 'Les textes monétaires imprimés sous le règne de Philippe le Beau (1482-1506)'. Villes d'imprimerie et moulins à papier du XIVe au XVIe siècle … colloque international, Spa, 11-14.IX.1973, Bruxelles, 1976, pp.165-96.
Cohen	Cohen, A. 'Hebrew incunabula at Cambridge'. Jewish Quaterly Review 19 (1907) pp. 744-50; 20 (1908) pp. 464-65.
Collijn, Ettbladstryck	Collijn, Isak. Ettbladstryck från femtonde århundradet. 2 vols. Stockholm, 1905-12.
Coll(L)	Collijn, Isak. Katalog öfver Linköpings stifts- och läroverksbiblioteks inkunabler. Uppsala, 1909. (Bibliotheca Ekmaniana, 7.)
Coll(Lübeck)	Collijn, Isak. 'Lübecker Frühdrucke in der Stadtbibliothek zu Lübeck'. Zeitschrift des Vereins für Lübeckische Geschichte und Altertumskunde 9 (1908), pp. 288-333 und Beilage, Tafel 1-26.
Coll(S)	Collijn, Isak. Katalog der Inkunabeln der Kgl. Bibliothek in Stockholm. 3 pt. Stockholm, 1914. (Nyförvärv 1915-1939 jämte tillägg. Kungl. Bibliotekets Handlingar, Bilagor 5. Uppsala, 1940.)
Coll(SB)	Collijn, Isak. Sveriges bibliografi intill år 1600. 3 vols. Uppsala, 1927-38.
Coll(U)	Collijn, Isak. Katalog der Inkunabeln der Kgl. Universitäts-Bibliothek zu Uppsala. Uppsala, 1907. (Bibliotheca Ekmaniana, 5.
Collura	Collura, Paolo. Notazione bibliografica degli incunabuli conservati nella Biblioteca Torres di Monreale. Reggio d'Emilia, 1936.
Colmar	Catalogue des incunables de la Bibliothèque de la Ville de Colmar. Paris, 1895.
Conti	Ginori Conti, Piero. Bibliografia delle opere del Savonarola. Vol.I (Prediche). Firenze, 1939.
Conway	Conway, William M. The woodcutters of the Netherlands in the fifteenth century. Cambridge, 1884.
Cook	Cook, Olan V. Incunabula in the Hanes Collection of the Library of the University of North Carolina. Enlarged edition. Chapel Hill, 1960.
Coq(Bordeaux)	Coq, Dominique. Catalogue des incunables de la Bibliothèque municipale de Bordeaux. Bordeaux, 1974.
Corsten(Ablass)	Corsten, Severin. 'Der Ablass zugunsten der Kathedrale von Saintes: seine Verkündigung am Niederrhein im Spiegel der Wiegendrucke'. Annalen des Historischen Vereins für den Niederrhein 177 (1975), pp. 62-75. 
Corsten(Anfänge)	Corsten, Severin. Die Anfänge des Kölner Buchdrucks. Köln, 1955.
Cosentini	Cosentini, Francesco. Gli incunaboli ed i tipografi piemontesi del secolo XV. Torino, 1914.
Cowley	Cowley, A.E. A concise catalogue of the Hebrew printed books in the Bodleian Library. Oxford, 1929.
CPhCat	Catalogue of the incunabula in the Library of the College of Physicians of Philadelphia. [1931]. (Reprinted from: Annals of Medical History, New Series 3 (1931) pp.228-40, 325-54, 439-54).
CR	Reichling, Dietrich. Appendices ad Hainii-Copingeri Repertorium Bibliographicum. Additiones et emendationes. 6 vols. & index. Monachii, 1905-11. (Supplement. Monasterii, 1914.).
Cx	Needham, Paul. 'Checklist of Caxton's printing'. The printer & the pardoner, Washington D.C., 1986 pp.83-91.
Dahm	Dahm, Inge. Aargauer Inkunabelkatalog. Aarau, 1985.
Dalbanne(Légendes)	Dalbanne, Claude. 'Remarques sur l'illustration de quelques légendes dorées imprimées à Lyon au quinzième siècle'. Documents paléographiques, typographiques, iconographiques … , 7 (1928) pp. 37-82.
Dal-Droz	Dalbanne, Claude and Droz, Eugenie. L'imprimerie à Vienne en Dauphiné au XVe siècle. Paris, 1930.
Daneo(Correr)	Daneo, Flavio. 'Indice degli incunaboli (Museo Correr).' Bollettino dei civici musei veneziani d'arte e di storia 34 (1990) pp.5-40, 35 (1991) pp.27-94.
Darlow & Moule	Darlow, T.H. and Moule, H.F. Historical catalogue of the printed editions of Holy Scripture … Vol.2. London, 1911.
Davies	Davies, H.W. Bernhard von Breydenbach and his journey to the Holy Land 1483-4. London, 1911.
Davies & Goldfinch	Davies, Martin and John Goldfinch. Vergil: A Census of Printed Editions 1469-1500. London, 1992.
DBI	Dizionario biografico degli italiani. Roma, 1960- [in progress].
De Marinis	De Marinis, Tammaro. Appunti e ricerche bibliografiche. Milano, 1940.
De Marinis, Livres à figures	De Marinis, Tammaro. Catalogue d'une collection d'anciens livres à figures appartenant à Tammaro de Marinis. Milano, 1925.
De Rossi	De Rossi, Johannes Bernardus. Annales hebraeo-typographici sec. XV. Parmae, 1795.
De Tommasi	De Tommasi, Alessandro. Notazione bibliografica degli incunabuli della Collegiata di S. Pietro di Broni. Reggio Emilia, 1936.
Deckert	Deckert, Helmut. Katalog der Inkunabeln der Sächsischen Landesbibliothek zu Dresden. 80. Beiheft zum ZfB. Leipzig, 1957.
Delisle	Delisle, Leopold. Chantilly, Le Cabinet des livres: imprimés antérieurs au milieu du XVIe siècle. Paris, 1905.
Delisle(Caen)	Delisle, Léopold, Catalogue des livres imprimés ou publiés à Caen avant le milieu du XVIe siècle. 2 Tom. Caen, 1903-04 (repr. Amsterdam, 1969).
DeR(C)	Ricci, Seymour de. A census of Caxtons.  Oxford, 1909. (Illustrated monographs issued by the Bibliographical Society, XV).
DeR(M)	Ricci, Seymour de. Catalogue raisonné des premières impressions de Mayence (1455-67). Mainz, 1911. (Veröffentlichungen der Gutenberg-Gesellschaft VIII-IX).
Dervieux	Dervieux, E. 'Incunabuli della biblioteca del Seminario di Asti'. Miscellanea di studi storici in onore di Antonio Manno, Vol.2, Torino, 1912, pp.451-80.
Desguine	Bibliothèque André Desguine (Nanterre). Les incunables: catalogue [par Annie Taurant-Boulicault]. Nanterre, 1992.
Dimitrovsky	Dimitrovsky, H.Z. S'ridei Bavli. 2 vols. New York, 1979.
Distelbrink	Distelbrink, Balduinus. Bonaventurae scripta authentica, dubia vel spuria critice recensita. Roma, 1975.
Döring(Freiberg)	Döring, Hellmut. 'Freiberger Inkunabelkatalog.' Beiträge zur Inkunabelkunde, Dritte Folge 9 (1993).
Dodgson(BM)	Dodgson, Campell. Woodcuts of the XV Century in the Department of Prints and Drawings, British Museum. 2 vols. London, 1934-35. (Reprinted Vaduz, 1980.)
Dokoupil	Dokoupil, Vladislav. Soupis prvotisků z fondů Universitní knihovny v Brne. Praha, 1970.
Dokoupil(Počátky)	Dokoupil, Vladislav. Počátky Brnenského knihtisku: prvotisky. Brno, 1974.
Donati	Donati, Lamberto. 'Le Problème de Lienhart Ysenhut', Libri 2 (1952/53), pp. 320-25.
Duff	Duff, E. Gordon. Fifteenth century English books. Oxford, 1917. (Illustrated monographs issued by the Bibliographical Society, XVIII.) Reprinted with supplement compiled by L .Hellinga. London, 2009.
Duff(Dial)	Duff, E. Gordon. The dialogue of communing between the wise King Salomon and Marcolphus. With a bibliography. London, 1892.
Duff(JRL)	Duff, E. Gordon. Catalogue of the printed books and manuscripts in the John Rylands Library, Manchester. 3 vols. Manchester, 1899.
Duggan	Duggan, Mary Kay. Italian music incunabula: printers and type. Berkeley, 1992.
Eames(C)	Eames, Wilberforce. 'Columbus' letter on the discovery of America (1493-97)'. Bulletin of the New York Public Library (1924) pp.595-99.
Eames-Sab(Ptol)	Eames, Wilberforce. A list of editions of Ptolemy's Geography, 1475-1730. New York, 1886. (Reprinted from: Sabin, Joseph. A dictionary of books relating to America. Vol.XVI. New York, 1886, pp.43-87).
Early Herbals	A catalogue of early herbals mostly from the well-known library of Dr. Karl Becher, Karlsbad. With an introduction by Dr. Arnold C. Klebs. Nyon Bulletin XII, L'Art Ancien S.A., Zürich, 1925.
Ecker	Ecker, Sabine. Einblattdrucke von den Anfängen bis 1555. Untersuchungen zur einer Publikationsform literarischer Texte. 2 Vols. Göppingen, 1981 (Göppinger Arbeiten zur Germanistik, Bd. 314/1.2)
Eisermann(Ablass)	Eisermann, Falk. 'Der Ablaß als Medienereignis. Kommunikationswandel durch Einblattdrucke im 15. Jahrhundert', Tradition and Innovation in an Era of Change / Tradition und Innovation im Übergang zur Frühen Neuzeit, Frankfurt a.M., 2001, pp.99-128 (Medieval to Early Modern Culture / Kultureller Wechsel vom Mittelalter zur frühen Neuzeit, vol. 1).
Eisermann(Ephemeriden)	Eisermann, Falk. 'Erfurter Ephemeriden. Perspektiven eines vielseitigen Mediums', Bücher und Bibliotheken in Erfurt (Erfurt, 2000), pp. 29-46.
Eisermann(Imprimerie)	Eisermann, Falk. 'Imprimerie et pouvoir au XVe siècle. Rudolf von Scherenberg, prince évêque de Würzburg, et son imprimeur Georg Reyser'. Kat.Paris 2002/2003, p.201-06.
Eisermann(Neufunde)	Eisermann, Falk. ''Hinter Decken versteckt'. Ein weiteres Exemplar des 31zeiligen Ablaßbriefs und andere Neufunde von Einblattdrucken das 15. Jahrhunderts.' Gb Jb 1999, pp.58-74.
Eisermann-Honemann	Eisermann, Falk und Volker Honemann. 'Die ersten typographischen Einblattdrucke'. Gb Jb 2000, pp. 88-131.
EJ	Meyer, H.M.Z. 'Incunabula'. Encyclopaedia Judaica vol.8. Jerusalem, 1972, col. 1319-44.
Elliott-Loose	Elliott-Loose, Ghislaine. Les incunables des anciens Pays-Bas conservés à la Réserve … de la Bibliothèque Nationale. Bordeaux, 1976.
Embach	Embach, Michael. Die Inkunabeln der Trierer Dombibliothek. Trier, 1995. (Veröffentlichungen des Bistumsarchiv Trier, 29).
Emden BRUC	Emden, A.B. Biographical register of the University of Cambridge to 1500. Cambridge, 1963.
Emden BRUO	Emden, A.B. Biographical register of the University of Oxford to AD 1500. 3 vols. Oxford, 1957-59.
Engel-Stalla	Engel, Hermann and Stalla, Gerhard. 'Die Brüder Johann und Konrad Hist und ihre Drucke'. AGB 16 (1976) col. 1649-80.
Ennen	Ennen, Leonhard. Katalog der Inkunabeln in der Stadtbibliothek zu Köln. Köln, 1865.
Erlangen-Ebl	Hofmann-Randall, Christina. Die Einblattdrucke der Universitätsbibliothek Erlangen-Nürnberg. Erlangen, 2003.
Erlangen(Kat.2000)	Bücher im Jahrhundert Gutenbergs:eine Ausstellung der Universitätsbibliothek, 10. November-3. Dezember 2000. Erlangen, 2000. (Schriftenreihe der Universität Erlangen-Nürnberg, Bd. 38).
Ernst(Hannover)	Ernst, Konrad. Die Wiegendrucke des Kestner-Museums … neu bearbeitet und ergänzt von Christian von Heusinger. Hannover, 1963.
Ernst(Hildesheim)	Ernst, Konrad. Incunabula Hildesheimensia. 2 vols. Hildeshemii, Lipsiae, 1908-09.
Essling	Masséna, Victor, Prince d'Essling. Les livres à figures vénitiens de la fin du XVe siècle et du commencement du XVIe. 4 vols. Florence, 1907-14.
FairMur(F)	Davies, Hugh William. Catalogue of a collection of early French books in the library of C. Fairfax Murray. 2 vols. London, 1910.
FairMur(G)	Davies, Hugh William. Catalogue of a collection of early German books in the library of C. Fairfax Murray. 2 vols. London, 1913.
Fav e Bres	Fava, Mariano and Bresciano, Giovanni. La stampa a Napoli nel XV secolo. 2 vols. Leipzig, 1911-12. (Sammlung bibliothekswissenschaftlicher Arbeiten, 32-33).
Fav(M)	Fava, Domenico. Catalogo degli incunabuli della R. Biblioteca Estense di Modena. Firenze, 1928. (Biblioteca di bibliografia italiana, 7).
Faye	Faye, C.U. Fifteenth century printed books at the University of Illinois. Urbana, 1949.
Feigelmanas	Feigelmanas, N. Lietuvos inkunabulai. Vilnius, 1975.
Fernillot	Fernillot, Yvonne. Catalogues régionaux des incunables des Bibliothèques publiques de France. Vol.XII: Bibliothèque de la Sorbonne. Paris, 1995.
Ferrari	Ferrari, L. 'Doctor Nicolaus Pol, la Collegiata di S. Candido ed i suoi incunabuli'. Atti del Reale Istituto Veneto di scienze, lettere ed arte 96 (1937) pp.109-69.
Ferrarini	Ferrarini, C. Incunabulorum quae in Civica Bibliotheca Mantuana adservantur catalogus. Mantuae, 1937.
Festgabe Konrad Haebler	Wiegendrucke und Handschriften. Festgabe Konrad Haebler zum 60. Geburtstage. Leipzig, 1919.
Finger	Finger, Heinz u.a. Universitäts-und Landesbibliothek Düsseldorf, Inkunabelkatalog. Wiesbaden, 1994. (Schriften der Universitäts- und Landesbibliothek Düsseldorf, 20).
Fiorillo	Fiorillo, R. Incunabuli delle biblioteche di Puglia con la indicazione di alcune artistiche rilegature. Napoli, 1942.
Fiske	Fowler, Mary. Cornell University Library: Catalogue of the Petrarch collection bequeathed by Willard Fiske. Oxford, 1916.
Foulché-Delbosc	Foulché-Delbosc, Raymond. 'Bibliographie de Juan de Mena'. Revue Hispanique 9 (1902) pp.114-38.
Frasson-Cochet	Frasson-Cochet, Dominique. Catalogues régionaux des incunables des Bibliothèques publiques de France. Vol.XVI: Auvergne, avec ... Pierre Aquilon. Genève, 2006.
Frati	Frati, Lodovico. 'Rarissimi incunabuli ritrovati nella R. Biblioteca universitaria di Bologna'. La Bibliofilia 17 (1915/17) pp.360-67.
Fredericq	Fredericq, Paul. Codex documentorum sacratissimarum indulgentiarum neerlandicarum: Verzameling van stukken betreffende de pauselijke aflaten in de Nederlanden (1300-1600). The Hague, 1922 (Rijks Geschiedkundige Publikatien, Kleine Serie, Bd.21.)
Freimann	Freimann, Aron. 'Über hebräische Inkunabeln'. ZfB 19 (1902) pp.108-17.
Freimann(Fr)	Freimann, Aron. 'Die hebräischen Inkunabeln der Stadtbibliothek zu Frankfurt a. M.' Festgabe für Friedrich Clemens Ebrard zur Vollendung seines 70. Lebensjahres, Frankfurt, 1920, pp.129-44.
Freys(Schützenbriefe)	Freys, Ernst. Gedruckte Schützenbriefe des 15. Jahrhunderts. München, 1912.
Füssel(Gutenberg)	Füssel, Stephan. Gutenberg und seine Wirkung. Frankfurt a.M./Leipzig, 1999.
Ganda(Lavagna)	Ganda, Arnoldo. Filippo Cavagni da Lavagna: editore, tipografo, commerciante a Milano nel Quattrocento. Firenze, 2006.
Ganda(Zarotus)	Ganda, Arnaldo. I primordi della tipografia milanese: Antonio Zarotto da Parma, 1471-1507. Firenze, 1984.
Gb Jb	Gutenberg-Jahrbuch. Mainz, 1926- [in progress].
Geissler(Ratdolt)	Geissler, Paul. 'Erhard Ratdolt'. Lebensbilder aus dem Bayerischen Schwaben 9 (1966), pp. 97-153.
Geldner	Geldner, Ferdinand. Die deutschen Inkunabeldrucker. Ein Handbuch der deutschen Buchdrucker des XV. Jahrhunderts nach Druckorten. 2 Bde. Stuttgart, 1968-70.
Geldner(Archivgut)	Geldner, Ferdinand. 'Frühdrucke als Archivgut'. Mitteilungen für die Archivpflege in Bayern 12 (1966), pp.10-14.
Geldner(Bamberg)	Geldner, Ferdinand. Die Buchdruckerkunst im alten Bamberg 1458/59 bis 1519. Bamberg, 1964.
Geldner(Inkunabelkunde)	Geldner, Ferdinand. Inkunabelkunde. Eine Einführung in die Welt des frühesten Buchdrucks. Wiesbaden, 1978. (Elemente des Buch- und Bibliothekswesens, Vol. 5.)
Geldner(Regula)	Geldner, Ferdinand. 'Wiegendruckausgaben der 'Regula Dominus que pars''. AGB 10 (1970) col. 646-54.
GfT	Gesellschaft für Typenkunde des XV. Jahrhunderts. Veröffentlichungen. Leipzig [etc], 1907ff.
Giesecke	Giesecke, Michael. Der Buchdruck in der frühen Neuzeit: eine historische Fallstudie über die Durchsetzung neuer Informations- und Kommunikationstechnologien. Frankfurt/M., 1991.
Giglio-Vignono	Giglio, Bruno and Vignono, Ilo. Incunaboli, cinquecentine … della Biblioteca capitolare d'Ivrea. 2 vols. Ivrea, 1989.
Ginsburg	Ginsburg, Christian D. Introduction to the Massoretico-critical edition of the Hebrew Bible. London, 1897.
Giovannozzi	Giovannozzi, Lucia. Contributo alla bibliografia delle opere del Savonarola: edizioni dei secc. XV e XVI. Firenze, 1953.
Girard	Girard, Alain. Catalogues régionaux des incunables des Bibliothèques publiques de France. Vol.IV: Bibliothèques de la Région Basse-Normandie. Bordeaux, 1984.
Gisi	Gisi, M. Verzeichniss der Incunabeln der Kantons-Bibliothek Solothurn. 2 pt. Solothurn, 1886-87.
Goff	Goff, Frederick R. Incunabula in American libraries: a third census. Millwood (N.Y.), 1973. (Reproduced from the annotated copy of the original edition (New York, 1964) maintained by Goff). (Supplement. New York, 1972.)
Goff(LC)	Goff, Frederick R. Fifteenth century books in the Library of Congress. Washington, D.C., 1950.
Goff(P)	Goff, Frederick R. 'The Postilla of Guillermus Parisiensis'. Gutenberg-Jahrbuch 1959 pp.73-78.
Goff(S)	Goff, Frederick R. 'The four Florentine editions of Savonarola's 'Predica dell'arte del bene morire''. The New Colophon (1950) pp.286-301.
Gonzálvez	Gonzálvez Ruiz, Ramón. 'La bulas de la Catedral de Toledo y la imprenta incunable castellana.' Boletín de la Real Academia de BB. Artes y CC. Historicas de Toledo 18 (1986) pp. 9-180.
Gordan	Gordan, Phyllis Goodhart. Fifteenth-century books in the library of Howard Lehman Goodhart. Stamford (Conn.), 1955.
Gossart	Gossart, Maurice. Catalogue des incunables d'origine néerlandaise conservés à la Bibliothèque Communale de Lille. Lille, 1907.
Gotzkowsky	Gotzkowsky, Bodo. 'Volksbücher': Prosaromane, Renaissancenovellen, Versdichtungen und Schwankbücher: Bibliographie der deutschen Drucke. Vol. 1: Drucke des 15. und 16.Jhs. Baden-Baden, 1991. (Bibliotheca Bibliographica Aureliana, 125.)
Govi	Govi, E. Patavinae cathedralis ecclesiae capitularis bibliotheca: librorum saec. XV impressorum index. Patavii, 1958.
Grebe(Landen)	Grebe, Werner. Der Kölner Frühdrucker Johann Landen und die Druckwerke seiner Offizin. Wiesbaden, 1983. (Buchwissenschaftliche Beiträge aus dem Deutschen Bucharchiv München, 6).
Gspan-Badalić	Gspan, Alfonz and Badalić, Josip. Inkunabule v Sloveniji (Incunabula quae in Slovenia asservantur). Ljubljana, 1957.
Günt(L)	Günther, Otto. Die Wiegendrucke der Leipziger Sammlungen und der Herzoglichen Bibliothek in Altenburg. XXXV. Beiheft zum ZfB. Leipzig, 1909.
Günt(Rezension)	Günther, Otto. 'Rezension zu GW(Einbl).' Zeitschrift für Bücherfreunde, Neue Folge 6, 1 (1914), Beiblatt, pp.132ff.
GW	Gesamtkatalog der Wiegendrucke. Bd. I [etc.] Stuttgart, etc., 1968- [in progress]. (Vols. 1-7 reproduced with additions and corrections from the original edition (Leipzig, etc., 1925-38)). [See also GW Manuskript - GW M: http://www.gesamtkatalogderwiegendrucke.de]
GW(Einbl)	Einblattdrucke des XV. Jahrhunderts: ein bibliographisches Verzeichnis hrsg. von der Kommission für den Gesamtkatalog der Wiegendrucke. Halle, 1914. (Sammlung bibliothekswissenschaftlicher Arbeiten, 35-36).
GW(Nachtr)	Nachträge zu Hain's Repertorium Bibliographicum und seinen Fortsetzungen als Probe des Gesamtkatalogs der Wiegendrucke, hrsg. von der Kommission für den Gesamtkatalog der Wiegendrucke. Leipzig, 1910.
H	Hain, Ludwig. Repertorium Bibliographicum in quo libri omnes ab arte typographica inventa usque ad annum MD. typis expressi ordine alphabetico vel simpliciter enumerantur vel adcuratius recensentur. 2 vols. Stuttgartiae, Lutetiae, 1826-38.
Haberditzl	Haberditzl, Franz Martin. Die Einblattdrucke des XV. Jahrhunderts in der Kupferstichsammlung der Hofbibliothek zu Wien. Bd.1: Die Holzschnitte. Wien, 1920.
Haeb(BI)	Haebler, Konrad. Bibliografía ibérica del siglo XV. 2 parts. La Haya, Leipzig, 1903-17.
Haeb(GSpF)	Haebler, Konrad. Geschichte des spanischen Frühdruckes in Stammbäumen. Leipzig, 1923.
Haebler(Falsche Gulden)	Haebler, Konrad. 'Falsche Gulden: Blätter aus der Frühzeit der Druckerkunst'. Zeitschrift für Bücherfreunde 11 (1907/1908), pp. 219-33.
Häkli	Häkli, Esko. Bartholomeus Ghotan: Suomen ensimmäisen kirjan painaja / Bartholomäus Ghotan: der Drucker des ersten Buchs für Finnland. Helsinki, 1991.
Halbey(GbMus)	Halbey, Hans Adolf u.a. Schrift … Druck … Buch im Gutenberg-Museum. Mainz, 1985.
Haller(Buchdruck Münsters)	Haller, Bertram. Der Buchdruck Münsters: 1485 bis 1583. Eine Bibliographie. Münster 1986.
Hargreaves	Hargreaves, G.D. A catalogue of medical incunabula in Edinburgh libraries. Edinburgh, 1976.
Harman	Harman, Marian. Incunabula in the University of Illinois Library at Urbana-Champaign. Urbana, 1978.
Harper Cat	Lathrop C. Harper Inc. [Sales catalogues]. New York, 1927-85.
Harr(BAV)	Harrisse, Henry. Bibliotheca americana vetustissima: a description of works relating to America, published between the years 1492 and 1551. New York, 1866. (Additions. Paris, 1872).
Harris(Orlando)	Harris, Neil. Bibliografia dell' 'Orlando innamorato'. 2 vol. Modena, 1988-91.
Harr(PIBâl)	Harrisse, Henry. Les premiers incunables Bâlois et leurs dérivés: Toulouse, Lyon, Vienne-en-Dauphiné, etc. 1471-1484. Paris, 1902.
Hase	Martin von Hase. Bibliographie der Erfurter Drucke von 1501-1550. Dritte Auflage. Nieuwkoop, 1968.
Hase(Sporer)	Martin von Hase. 'Hans Sporer und seine Erfurter Zeit (1494-1500)'. AGB 7 (1966), col. 1141-1152.
HC	Copinger, W.A. Supplement to Hain's Repertorium Bibliographicum. Part I. London, 1895.
HC(Add)	Copinger, W.A. Supplement to Hain's Repertorium Bibliographicum, Addenda to Part I. In: Copinger, W.A. Supplement to Hain's Repertorium … Part II, vol.2, London, 1902, pp.235-91.
HCR	Reichling, Dietrich. Appendices ad Hainii-Copingeri Repertorium Bibliographicum … Emendationes. 6 vols. & index. Monachii, 1905-11. (Supplement, Monasterii, 1914.)
Heitz, Einblattdrucke	Einblattdrucke des fünfzehnten Jahrhunderts. Hrsg. von Paul Heitz. Bd. 1-100. Strassburg, 1906-42.
Heitz, Einzelbilder	Heitz, Paul. Hundertfünfzig Einzelbilder des XV. Jahrhunderts. Strassburg, 1918.
Heitz-Haeb	Heitz, Paul. Hundert Kalender-Inkunabeln mit begleitendem Text von Konrad Haebler. Strassburg, 1905.
Heitz-Schultz, Flugblätter	Flugblätter des Sebastian Brant. Hrsg. von Paul Heitz. Mit einem Nachwort von F. Schultz. Strassburg, 1915.
Hejnic	Hejnic, Josef. Catalogus Incunabulorum quae in Museo Bohemiae Occidentalis Plznae asservantur. Soupis prvotisků Západočeského Muzea v Plzni. Plzeň, 2000. (Fontes bibliothecarum Musei Plznensis, vol.1.)
Hélin	Hélin, Maurice. La clef des songes: facsimiles, notes et liste des editions. Paris, 1925.
Hellwig	Hellwig, Barbara. Inkunabelkatalog des Germanischen Nationalmuseums Nürnberg. Wiesbaden, 1970.
Herz(Reise)	Herz, Randall. Die 'Reise ins Gelobte Land' Hans Tuchers des Älteren (1479-80). Wiesbaden, 2002. (Wissensliteratur im Mittelalter, Vol. 38.)
Hill	Hill, B.S. Incunabula, Hebraica and Judaica … [Exhibition catalogue]. Ottawa, 1981.
Hillard	Hillard, Denise. Catalogues régionaux des incunables des Bibliothèques publiques de France. Vol.VI: Bibliothèque Mazarine. Paris, Bordeaux, 1989.
Hisp	Penney, Clara Louise. List of books printed before 1601 in the Library of the Hispanic Society of America. New York, 1929. (Offset reissue, with additions. New York, 1955).
Hoepli	Hoepli, Ulrico. Editori e stampatori italiani del Quattrocento: note biobibliografiche. Milan, 1929.
Hoffman	Hoffman, Margit. 'Fem hebraiska inkunabeler i Kungliga biblioteket'. Biblis (1974) pp.8-28.
Hoffmann(Almanache)	Hoffmann, Leonhard. 'Almanache des 15. und 16. Jahrhunderts und ihre Käufer'. Beiträge zur Inkunabelkunde Dritte Folge 8 (1983), pp. 130-43.
Holter, Ablassbriefe	Holter, Kurt. 'Gedruckte Ablassbriefe und verwandte Einblattdrucke des 15. Jahrhunderts aus Oberösterreichischen Archiven und Bibliotheken'. Jahrbuch des Oberösterreichischen Musealvereines 114 (1969) pp. 105-16.
Holter(Kremsmünster)	Holter, Kurt. Die Wiegendrucke des Stiftes Kremsmünster. Linz/Donau, 1947.
Holtrop	Holtrop, Jan Willem. Monuments typographiques des Pays-Bas au quinzième siècle. Collection de facsimile d'après les originaux conservés à la Bibliothèque royale de la Haye et ailleurs. The Hague, 1868.
Honemann(Einblattdrucke)	Volker Honemann [et al.]. Einblattdrucke des 15. und frühen 16. Jahrhunderts: Probleme, Perspektiven, Fallstudien. Tübingen, 2000.
Honemann(Flugblätter)	Honemann, Volker. 'Zum deutschen Einblattdruck des 15. und frühen 16. Jahrhunderts.' Humanismus und früher Buckdruck: Akten des interdisziplinären Symposions vom 5./6. Mai 1995 in Mainz. Nürnberg, 1996 (Pirckheimer-Jahrbuch 11) pp. 15-41.
Horch(Rio)	Horch, Rosemarie Erika. Catálogo de incunábulos da Biblioteca Nacional do Rio de Janeiro. Rio de Janeiro, 1956. ('Suplemento'. Beiträge zur Inkunabelkunde, Dritte Folge, 8 (1983) pp.30-43).
Hortis	Hortis, Attilio. Catalogo delle opere di Francesco Petrarca esistenti nella Petrarchesca Rossettiana di Trieste. Trieste, 1874.
HPT	Hellinga, Wytze and Lotte. The fifteenth-century printing types of the Low Countries. 2 vols. Amsterdam, 1966.
HR	Reichling, Dietrich. Appendices ad Hainii … Repertorium Bibliographicum. Emendationes. 6 vols & index. Monachii, 1905-11. (Supplement, Monasterii, 1914.)
HSTC	A short-title catalogue of the Hebrew incunables and other books illustrated in the 'Thesaurus'. Compiled by H.M.Z. Meyer for the 1967-69 Jerusalem reprint of Thes.
Hubay(Augsburg)	Hubay, Ilona. Incunabula der Staats- und Stadtbibliothek Augsburg. Wiesbaden, 1974.
Hubay(Eichstätt)	Hubay, Ilona. Incunabula Eichstätter Bibliotheken. Wiesbaden, 1968.
Hubay(Neuburg)	Hubay, Ilona. Incunabula aus der Staatlichen Bibliothek Neuburg/Donau. Wiesbaden, 1970.
Hubay(Würzburg)	Hubay, Ilona. Incunabula der Universitätsbibliothek Würzburg. Wiesbaden, 1966.
Hübl	Hübl, Albert. Die Inkunabeln der Bibliothek des Stiftes Schotten in Wien. Wien, 1904.
Hummel(Heilbronn)	Hummel, Heribert. Katalog der Inkunabeln des Stadtarchivs Heilbronn. Heilbronn, 1981. (Veröffentlichungen des Archivs der Stadt Heilbronn, Vol. 24.)
Hummel(Schlägl)	Hummel, Heribert. Katalog der Inkunabeln der Stiftsbibliothek Schlägl: eine Festgabe für Dipl.-Ing. Florian Pröll. Linz, 1983. (Schlägler Schriften, Bd. 8.)
Hummel(Weissenhorn)	Hummel, Heribert. Museums- und Kapitelsbibliothek Weissenhorn: Inkunabeln, Frühdrucke und Handschriften 1461-1600. Weissenhorn, 1983. (Kataloge des Museums Weissenhorn, Bd.1.)
Hummel-Wilhelmi	Hummel, Heribert and Thomas Wilhelmi. Katalog der Inkunabeln in Bibliotheken der Diözese Rottenburg-Stuttgart. Wiesbaden, 1993.
Hunt	Mead, Herman R. Incunabula in the Huntington Library. San Marino, California, 1937.
Huth	Catalogue of the fifty manuscripts & printed books bequeathed to the British Museum by Alfred H. Huth. London, 1912.
Iakerson	Iakerson, S. Catalogue of Hebrew incunabula from the collection of the Library of the Jewish Theological Seminary of America. 2 vols. New York, 2004/05.
IBE	Biblioteca Nacional [Madrid]. Catálogo general de incunables en bibliotecas españolas. Coordinado y dirigido por Francisco García Craviotto. 2 vols. Madrid, 1989-90. (Adiciones y correcciones. I-II, Madrid, 1991-94).
IBP	Incunabula quae in bibliothecis Poloniae asservantur. Moderante Alodia Kawecka-Gryczowa. Composuerunt Maria Bohonos and Eliza Sandorowska. 2 vols. Wrocław, 1970. (Addenda, Indices. Wrocław, 1993).
IBPort	Os incunábulos das bibliotecas portuguesas. Inventário do Património Cultural Móvel. Coord. e org. Maria Valentina C.A. Sul Mendes. Lisboa, 1995.
IDL	Incunabula in Dutch libraries. Editor-in-chief Gerard van Thienen. 2 vols. Nieuwkoop, 1983. (Supplement [in preparation]).
IGI	Indice generale degli incunaboli delle biblioteche d'Italia. Compilato da T.M. Guarnaschelli e E. Valenziani [et al.]. 6 vols. Roma, 1943-81.
IJL2	Yukishima, Koichi. Union catalogue of incunabula in Japanese libraries. 2nd edition. Tokyo, 2004.
ILC	Incunabula printed in Low Countries. Edited by Gerard van Thienen &John Goldfinch. Nieuwkoop, 1999.
Illustrated Bartsch 80-87	The Illustrated Bartsch. German book Illustration before 1500. Ed. Walter L. Strauss. New York, [n.d.]
Illustrated Bartsch 161-165	The Illustrated Bartsch (Supplement), German Single-Leaf Woodcuts before 1500. Ed. Richard S. Field. New York, 1987-99.
INKA	INKA - Inkunabelkatalog deutscher Bibliotheken. http://www.ub.uni-tuebingen.de/pro/kata/inka.php
Inv Ant	Inventaris van incunabelen gedrukt te Antwerpen 1481-1500. Antwerpen, 1982.
Isaac	Isaac, Frank. An index to the early printed books in the British Museum. Part II, MDI-MDXX, Italy, Switzerland, and Eastern Europe. London, 1938.
Jacobs	Jacobs, Joseph. 'Check-list of Hebrew incunabula'. Jewish Encyclopedia, vol.VI, New York and London, 1904, pp.578-79.
Jagiellonska	A. Lewicka-Kamińska. Inkunabuły Biblioteki Jagiellońskiej. Kraków, 1962.
Jammes	Jammes, Bruno. Catalogues régionaux des incunables des Bibliothèques publiques de France. Vol.VII: Bibliothèque de l'Institut de France, Bibliothèque Thiers. Paris, 1990.
Jaspers	Jaspers, G.J. De blokboeken en incunabelen in Haarlems Libry. Haarlem, 1988.
JCBCat	John Carter Brown Library. Bibliotheca americana: catalogue of the John Carter Brown Library in Brown University. Vol.I. Providence, 1919.
Juntke	Juntke, Fritz. 'Die Inkunabeln der Marienbibliothek zu Halle'. Beiträge zur Inkunabelkunde, Dritte Folge 5 (1974).
Juntke(Ablassbriefe)	Juntke, Fritz. 'Unbekannte Ablaßbriefe des XV. und XVI. Jahrhunderts'. ZfB 51(1934), pp. 547-55.
Juntke(Domstiftsbibliotheken)	Juntke, Fritz. Die Wiegendrucke der Domstiftsbibliotheken zu Merseburg und Naumburg. Halle(Saale), 1940.
Jurina	Jurina, Kitti. Vom Quacksalber zum Doctor Medicinae: die Heilkunde in der deutschen Graphik des 16. Jahrhunderts. Köln, 1985.
Kaeppeli	Kaeppeli, Thomas. Scriptores Ordinis Praedicatorum medii aevi. Vol. 1 [etc.] Romae, 1970- [in progress].
Kallendorf	Kallendorf, Craig. A Bibliography of Venetian Editions of Virgil, 1470-1599. Firenze, 1991.
Kaplan	Kaplan, H.G. A first census of incunabula in Australia and New Zealand. Sydney, 1966.
Karataev	Karataev, I. Opisanie slavyanorusskikh knig, napechatannykh kirillovskimi bukvami. Sankt-Petersburg, 1883.
Kat.Braunschweig 1985	Stadt im Wandel: Kunst und Kultur des Bürgertums in Norddeutschland 1150-1650: Landesausstellung Niedersachsen 1985 (4 vols.). Stuttgart, Bad Cannstadt, 1985.
Kat.Cambridge 1993	Late medieval art in Cambridge collections. Cambridge, Fitzwilliam Museum, 13 July-19 Sept. 1993. Cambridge, 1993.
Kat.Göttingen 1995	Gutenberg und der europäische Frühdruck: zur Erwerbungsgeschichte der Göttinger Inkunabelsammlung. Göttingen, 1995.
Kat.Göttingen 2000	Gutenberg und seine Wirkung: Katalog zur Ausstellung der Niedersächsischen Staats- und Universitätsbibliothek Göttingen vom 23. Juni-29. Oktober 2000. Frankfurt a.M./Göttingen, 2000.
Kat.Groningen 2001	Hel en Hemel: de Middeleeuwen in het Noorden, Groninger Museum, 13 Apr.-2 Sept. 2001. Groningen, 2001.
Kat.Karlsruhe 2001/02	Spätmittelalter am Oberrhein: Katalog der Landesausstellung Baden-Württemberg, Staatliche Kunsthalle und Badisches Landesmuseum Karlsruhe, 29. Sept. 2001 - 3. Febr. 2002. 2 pts. in 3 vols. Stuttgart, 2001.
Kat.Koblenz/Worms 1995	1495 - Kaiser Reich Reformen: der Reichstag zu Worms. Ausstellung des Landeshauptarchivs Koblenz in Verbindung mit der Stadt Worms zum 500jährigen Jubiläum des Wormser Reichstags von 1495. Museum der Stadt Worms im Andreasstift 20. August-19. November 1995. Koblenz, 1995.
Kat.Luxembourg 1972	Bibliothèque Nationale de Luxembourg. Les acquisitions du Départements de la Réserve précieuse en 1971. Luxembourg, 1972.
Kat.Mainz 2000	Gutenberg - aventur und kunst. Vom Geheimunternehmen zur ersten Medienrevolution. Katalog zur Ausstellung …, 14. Apr. – 3 Oct. 2000. Mainz, 2000.
Kat.München 1990	Die Graphiksammlung des Humanisten Hartmann Schedel: Ausstellung Bayerische Staatsbibliothek 20. June - 15. Sept. 1990. München, 1990 (Bayerische Staatsbibliothek, Ausstellungskataloge, Vol. 52).
Kat.Nijmegen 1990	Gheprint te Nymeghen: mijmeegse drukkers, uitgevers en bookverkopers 1479-1794. Nijmegen, 1990. (Catalogi van het kunstbezit van de Gemeente Nijmegen, Vol. 6.)
Kat.Nürnberg 1983	Martin Luther und die Reformation in Deutschland: Ausstellung zum 500. Geburtstag Martin Luthers. Frankfurt a.M., 1983.
Kat.Nürnberg 2000	Spiegel der Seligkeit: Privates Bild und Frömmigkeit im Spätmittelalter. Ausstellung Germanisches Nationalmuseum in Nürnberg, 31. Mai- 8. Okt. 2000. Nürnberg, 2000.
Kat.Paris 2002/2003	Les trois révolutions du livre (exhibition, Musée des Arts et Métiers, Paris, 8 Oct. 2002 - 5 Jan.2003). Paris, 2002.
Kat.Washington 1965	Fifteenth Century Woodcuts & Metalcuts from the National Gallery of Art, Washington DC. Washington, 1965.
Kat.Wetzlar 2002	Kaiser Maximilian I: Bewahrer und Reformer. Ausstellung vom 2. August-31. Oktober 2002 im Reichskammergerichtsmuseum Wetzlar. Ramstein, 2002.
Kat.Wolfenbüttel 1972	Incunabula Incunabulorum: Früheste Werke der Buchdruckkunst: Mainz, Bamberg, Straßburg 1454-1469. Ausstellung im Renaissancesaal des Wolfenbütteler Schlosses. [N.pl., 1972. (Ausstellungskataloge der Herzog August Bibliothek, Bd. 62.)
Kat.Zwickau 1979	Kostbarkeiten der Ratsbibliothek Zwickau. Zwickau, 1979.
Kaufmann-Nabholz	Kaufmann, Hans and Nabholz, Peter. Verzeichnis schweizerischer Inkunabeln und Frühdrucke. Fasc.1-3. Zürich, 1968-1974.
Kiselev	Kiselev, N.P. Inventar' inkunabulov vsesoyuznoi biblioteki imenii V.I. Lenina. Moskva, 1939.
Kiselev(1961)	Kiselev, N.P. Neizvestnye fragmenty drevneishikh pamyatnikov pechati Germanii i Gollandii. Moskva, 1961.
Klebs	Klebs, Arnold C. Incunabula scientifica et medica: short title list. Bruges, 1938. (Reprinted from Osiris, vol.IV.)
Klebs(Gart)	Klebs, Arnold C. 'Herbals of the 15th century: Gart der Gesundheit'. BSA 12 (1918) pp. 42-48.
Klebs(H)	Klebs, Arnold C. 'Herbals of 15th century'. BSA 11 (1917) pp. 75-92, 12 (1918) pp. 41-57.
Klebs(Hortus)	Klebs, Arnold C. 'Herbals of 15th century: Hortus sanitatis'. BSA 12 (1918) pp. 48-51.
Klebs(P)	Klebs, Arnold C. Geschichtliche und bibliographische Untersuchungen. Klebs, A.C. & Sudhoff, K. Die ersten gedruckten Pestschriften. München, 1926.
Kocowski	Kocowski, Bronisław. Katalog inkunabułów biblioteki uniwersyteckiej we Wrocławiu. Catalogus incunabulorum typographicorum Bibliothecae Universitatis Wratislaviensis. 3 vols. Wrocław, 1959-77.
Koegler(Kalender)	Koegler, Hans. 'Einige Basler Kalender des XV ... Jahrhunderts'. Anzeiger für schweizerische Altertumskunde, Neue Folge, 11 (1909) pp. 153-69, 235-46, 33049.
Kok	Kok, Ina. De houtsneden in de incunabelen van de Lage Landen 1475-1500. Academisch proefschrift, Universiteit van Amsterdam, October 1994.
Kotvan	Kotvan, Imrich. Inkunábuly na Slovensku. Matica Slovenska, 1979.
Kotvan(Bratislava)	Kotvan, Imrich. Inkunábuly Univerzitnej Knižnice v Bratislave. Bratislava, 1960.
Kotvan(Martin)	Kotvan, Imrich. Inkunábuly Knižnice Matice Slovenskey v Martine. Martin, 1961.
Krajcar	Krajcar, J. 'Early-printed Slavonic books in the Library of the Pontifical Oriental Institute'. Orientalia christiana periodica 24 (1968) pp.105-208.
Krist	Kristeller, Paul. Early Florentine woodcuts. London, 1897.
Krist Lomb	Kristeller, Paul. Die lombardische Graphik der Renaissance. Berlin, 1913.
Krüger	Krüger, Nilüfer. Die Inkunabeln der Universitätsbibliothek Rostock mit den Inkunabeln der Landesbibliothek Mecklenburg-Vorpommern in Schwerin und der Kirchenbibliothek Friedland. Wiesbaden, 2003. (Kataloge der Universitätsbibliothek Rostock, 2.)
Küchenmeisterei	Küchenmeisterei in Nürnberg von Peter Wagner um 1490 gedruckt: Faksimile, eingeleitet von Hans Wegener mit … einer Bibliographie. Leipzig 1939. (Veröffentlichungen der Gesellschaft für Typenkunde des XV. Jahrhunderts. Reihe B III).
Kurz	Kurz, Martin. Handbuch der iberischen Bilddrucke des XV. Jahrhunderts. Leipzig, 1931.
L. Hellinga, Further fragments	Hellinga, L. 'Further fragments of Dutch prototypography'. Quaerendo 2 (1972) pp.182-99.
Lacombe	Lacombe, Paul. Livres d'heures imprimés au XVe et au XVIe siècle, conservés dans les bibliothèques publiques de Paris. Paris, 1907.
Langer-Dolch	Bibliographie der österreichischen Drucke des XV. und XVI. Jahrhunderts. Hrsg. von Eduard Langer. Bd.I, H.I: Trient-Wien-Schrattenthal. Bearbeitet von Dr. Walther Dolch. Wien, 1913.
LC(Exhib 15th c)	Library of Congress. Exhibit of books printed during the XVth century and known as incunabula. Washington D.C., 1930.
Leemann-van Elck	Leemann-van Elck, Paul. 'Zürcher Wiegendrucke'. Der Schweizer Sammler 6 (1932), pp. 141-144, pp. 200-04.
Lefèvre	Lefèvre, Martine. Catalogues régionaux des incunables des Bibliothèques publiques de France. Vol.II: Bibliothèques de la région Languedoc-Roussillon. Bordeaux, 1981.
Lehmann-Haupt	Lehmann-Haupt, Hellmut. Peter Schoeffer of Gernsheim and Mainz with a list of his surviving books and broadsides. New York, 1950.
Lenz	Lenz, Rudol Ferdinand. Inkunabel-Katalog der Erzbischöflichen Diözesan- und Dombibliothek Köln. Köln, 1997.
Leuze(Isny)	Leuze, Otto. Die Wiegendrucke der Bibliothek der Ev. Nikolauskirche in Isny. Stuttgart, 1916.
Leuze(Makulatur)	Leuze, Otto. 'Zehn Jahre Makulaturforschung in der Inkunabelsammlung der Württembergischen Landesbibliothek in Stuttgart', in: ZfB 48 (1931), pp. 1-8.
Ley(Petrarca)	Ley, Klaus. Die Drucke von Petrarcas 'Rime': 1470-2000; synoptische Bibliographie der Editionen und Kommentare, Bibliotheksnachweise. Hildesheim, Zürich, New York, 2002.
Liecht	Bohatta, Hanns. Katalog der Inkunabeln der Fürstlich Liechtenstein'schen Fideikommiss-Bibliothek und der Hauslabsammlung. Wien, 1910.
Lièvre(Poitiers)	Lièvre, A.F. Catalogue de la Bibliothèque de la Ville de Poitiers. Poitiers, 1895.
Livros antigos portuguezes	Manuel II, king of Portugal. Livros antigos portuguezes 1489-1600 da Bibliotheca de Sua Majestade … .I: 1489-1539. Londres, 1929.
Lohmeier(Ghotan)	Lohmeier, Dieter. 'Nachträge und Berichtigungen zum Verzeichnis der Drucke Bartholomäus Ghotans'. Zeitschrift des Vereins für Lübeckische Geschichte und Altertumskunde 72 (1992), pp. 47-65.
Lőkkös(Cat BPU)	Lőkkös, Antal. Les incunables de la Bibliothèque de Genève. Genève, 1982.
Lőkkös(Genève)	Lőkkös, Antal. Catalogue des incunables imprimés à Genève 1478-1500. Genève, 1978.
Louda	Louda, Jiří. Soupis prvotisků Universitní knihovny v Olomouci a její pobočky v Kroměříži. Praha, 1956.
Ludwig(Klosterneuburg)	Ludwig, Vinzenz Oskar. Die Klosterneuburger Inkunabeln. Wien/Leipzig, 1920 (Jahrbuch des Stiftes Klosterneuburg, Vol. 8,2).
Macf	Macfarlane, John. Antoine Vérard. London, 1910. (Illustrated monographs issued by the Bibliographical Society, VII).
Machiels	Machiels, J. Meester Arend de Keysere 1480-1490. Gent, 1973.
Machiels(Gent)	Machiels, J. Catalogus van de boeken gedrukt voor 1600 aanwezig op de Centrale Bibliotheek van de Rijksuniversiteit Gent. Gent, 1979.
Madrid	García Rojo, Diosdado and Ortiz de Montalván, Gonzalo. Catálogo de incunables de la Biblioteca Nacional [Madrid]. Madrid, 1945. (Apéndices I-IV. Madrid, 1958-2004).
Madsen	Madsen, Viktor. Katalog over det Kongelige Biblioteks inkunabler. 3 vols. København, 1935-63. (P.R. Jorgensen. 'Nye inkunabler … '. Fund og Forskning 30 (1991) pp. 133-38.)
Mälzer(Würzburg)	Mälzer, Gottfried. Die Inkunabeln der Universitätsbibliothek Würzburg. Würzburg, 1986.
Maignien(Grenoble)	Maignien, Edmond. Catalogue des incunables de la Bibliothèque Municipale de Grenoble. Macon, 1899.
Mambelli	Mambelli, Giuliano. Gli annali delle edizioni virgiliane. Firenze, 1954. (Biblioteca di bibliografia italiana, 27).
Manzoni	Manzoni, G. Annali tipografici dei Soncino. Bologna, 1886.
Marchini	Marchini, Luigi. Catalogo degli incunaboli della Biblioteca Civica Berio di Genova. Firenze, 1962. (Biblioteca di bibliografia italiana, 40).
Marston	Marston, Thomas E. Incunabula in the Yale University libraries. New Haven, 1955.
Martimort	Martimort, Aimé-Georges. 'Missels incunables d'origine franciscaine'. Mélanges liturgiques offerts au R.P. Dom Bernard Botte, Louvain, 1972, pp.359-78.
Martini	Bibliothèque Joseph Martini. Première partie. Vente 27-29 Août 1934, Lucerne. Milan, [1934]. Deuxième partie. Vente 21-23 Mai 1935, Zürich. Milan, [1935].
Martini(C)	Catalogo della libreria di Giuseppe Martini compilato dal possessore. Parte prima, Incunabuli. Milan, 1934.
Marx	Marx, Moses. 'Catalogue of Hebrew books printed in the fifteenth century now in the Library of the Hebrew Union College'. Studies in bibliography and booklore 1 (June 1953) pp.21-47.
Mattmann(Beromünster)	Mattmann, Helene. 'Inkunabelverzeichnis der Stiftsbibliothek Beromünster'. Erster datierter Schweizer Druck: Gedenkschrift zur 500-Jahr-Feier in Beromünster 1470-1970, Beromünster, 1970, pp.88-151.
Meltz	Meltz, Carl. 'Die Drucke der Michaelisbrüder zu Rostock 1476 bis 1530'. Wissenschaftliche Zeitschrift der Universität Rostock 5 (1955/56) pp.229-43.
Melzi	Melzi, Gaetano. Bibliografia dei romanzi e poemi cavallereschi italiani. 2a ed. Milano, 1838.
Mendes	Mendes, Maria Valentina C.A. Sul. Catálogo de incunábulos [Biblioteca Nacional, Lisbon]. Lisboa, 1988.
Mendham	Hingley, Sheila and David Shaw. Catalogue of the Law Society's Mendham Collection … housed in Canterbury Cathedral Library. London, 1994.
Meyer(Bücheranzeige)	Meyer, Karl. 'Eine Bücheranzeige des 15. Jahrhunderts'. ZfB 9 (1892), pp. 130-34.
Meyer(Bücheranzeigen)	Meyer, Wilhelm. 'Bücheranzeigen des 15. Jahrhunderts'. In: ZfB 2 (1885), pp. 437-63.
Meyer(Fribourg)	W. J. Meyer. Catalogue des incunables de la bibliothèque cantonale et universitaire de Fribourg, Suisse. Fribourg, 1917.
Meyer-Baer	Meyer-Baer, Kathi. Liturgical music incunabula, a descriptive catalogue. London, 1962.
Mich	Michelitsch, Anton. Thomasschriften. Graz & Wien, 1913.
Michelini Tocci	Michelini Tocci, Luigi. 'Incunaboli sconosciuti e incunaboli mal conosciuti della Biblioteca Vaticana'. Studi di bibliografia e di storia in onore di Tammaro De Marinis, [Rome], 1964, t.3 pp.177-228.
MirR	Wiegendruckgesellschaft. Mirabilia Romae: Rome: Stephan Plannck, 20 November, 1489. [Facsimile edition] Mit einer Einleitung von Christian Hülsen. Berlin, 1925.
Mitchell(Aberdeen)	Mitchell, William Smith. Catalogue of the incunabula in Aberdeen University Library. Edinburgh, 1968.
Mittler-Kind	Mittler, Elmar und Kind, Helmut. Incunabula Gottingensia: Inkunabelkatalog der Niedersächsischen Staats- und Universitätsbibliothek Göttingen. Bd.1 etc. Wiesbaden, 1995- [in progress].
More Books	More Books: the Bulletin of the Boston Public Library. Vol.IV, No.9 (Nov. 1929) -Vol. XIII, No.2 (Feb. 1938).
Moreau	Moreau, Brigitte. Inventaire chronologique des éditions parisiennes du XVIe siècle. I:1501 -1510; II: 1511-1520; III: 1521-1530; IV: 1531-1535. Paris, 1972-93.
Morg	Thurston, Ada and Bühler, Curt F. Check list of fifteenth century printing in the Pierpont Morgan Library. New York, 1939.
Morg(B)	Pollard, A.W. Catalogue of … early printed books from the libraries of William Morris, Richard Bennett … and other sources now forming portion of the library of J. Pierpont Morgan. 3 vols. London, 1907.
Mor(P)	Morgan, Morris H. A bibliography of Persius. Cambridge (Mass.), 1909. (Bibliographical contributions of the Library of Harvard University, 58).
Nagel	Nagel, Koostanud Olev. Inkunaablid. Tartu Riikliku Ülikooli Teaduslikus Raamatukogus. Kataloog. Tallinn, 1982.
Needham(Corsten Festschrift)	Needham, Paul. 'William Caxton and his Cologne partners'. Ars impressoria: Festgabe für Severin Corsten, München, 1986, pp.103-31.
Nemirovsky(Cyrillic)	Nemirovsky, Evgeny L. Gesamtkatalog der Frühdrucke in kyrillischer Schrift. Band I: Inkunabeln. Baden-Baden, 1996. (Bibliotheca bibliographica aureliana 140).
Nentwig	Nentwig, Heinrich. Die Wiegendrucke in der Stadtbibliothek zu Braunschweig. Wolfenbüttel, 1891.
Neveu	Neveu, Valérie. Catalogues régionaux des incunables des Bibliothèques publiques de France. Vol.XVII: Haute-Normandie. Genève, 2005.
Nickel(Erfurt)	Nickel, Holger. 'Zum Erfurter Buchdruck im 15. Jahrhundert'. Erfurt: Geschichte und Gegenwart, Weimar, 1995, pp. 333-40. (Schriften des Vereins für Geschichte und Altertumskunde von Erfurt, Vol. 2).
Nickel(Nixstein)	Nickel, Holger. 'Zum Ablassbrief des Johannes Nixstein, 1482'. Honemann(Einblattdrucke) pp. 467-77.
Nickel(Zwickau)	Nickel, Holger. Die Inkunabeln der Ratsschulbibliothek Zwickau. [Dissertation. Unpublished MS, 1976]
Niederdeutsche HSS und Inkunabeln	Niederdeutsche Handschriften und Inkunabeln: Ausstellung … der Herzog August Bibliothek Wolfenbüttel (9-26 Juni, 1976). Wolfenbüttel, 1976.
Nielsen	Nielsen, Lauritz. Dansk Bibliografi 1482-1550. København, 1919.
Nijhoff & Kronenberg	Nijhoff, Wouter and Kronenberg, M.E. Nederlandsche bibliographie van 1500 tot 1540. 3 vols. 's-Gravenhage, 1923-71.
Norton(1966)	Norton, F.J. Printing in Spain 1501-1520. Cambridge, 1966.
Norton(1978)	Norton, F.J. A descriptive catalogue of printing in Spain and Portugal 1501-1520. Cambridge, 1978.
Oates	Oates, J.C.T. A catalogue of the fifteenth-century printed books in the University Library Cambridge. Cambridge, 1954.
Odriozola(Parix)	Odriozola, Antonio. 'Los protoincunables (1472-1478) impresos por Juan Parix en Segovia (España) y Toulouse (Francia)'. Gb Jb 1976 pp.130-37.
Offenberg	Offenberg, A.K. Hebrew incunabula in public collections: a first international census. Nieuwkoop, 1990.
Offenberg(De Graaf Festschrift)	Offenberg, A.K. 'Wat niet in Census staat'. For Bob de Graaf, Amsterdam, 1992, pp. 144-51.
Offenberg(Rosenthal)	Offenberg, A.K. 'Catalogue of the Hebrew incunabula in the Bibliotheca Rosenthaliana'. Studia Rosenthaliana 5 (1971), 7 (1973).
Ohly-Sack	Ohly, Kurt and Sack, Vera. Inkunabelkatalog der Stadt- und Universitätsbibliothek und anderer öffentlicher Sammlungen in Frankfurt am Main. 5 vols. Frankfurt a.M., 1966-67.
Oldenbourg	Oldenbourg, M. Consuelo. Hortulus animae [1494]-1523. Bibliographie und Illustration. Hamburg, 1973.
Olivar	Olivar, Alexandre. Les incunables conservats a la biblioteca de Montserrat. Montserrat, 1990.
Omaggio a Gutenberg	Studi e ricerche sulla storia della stampa del Quattrocento: omaggio dell'Italia a Giovanni Gutenberg nel V centenario della sua scoperta. Milan, 1942.
Osler(IM)	Osler, Sir William. Incunabula medica: a study of the earliest printed medical books, 1467-80. Oxford, 1923. (Illustrated monographs issued by the Bibliographical Society, XIX).
Oslo	Amundsen, Leiv. Det Kongelige Fredriks-Universitet: Katalog over Universitetsbibliotekets paleotypsamling. Oslo, 1926.
Ostermann(Kurczweil)	Ostermann, Marcus. 'Vmb kurczweil vnd schiessens willen. Zu den gedruckten Schützenbriefen des 15. Jahrhunderts'. Honemann(Einblattdrucke) pp. 397-443.
Pad-Ink	Hartig, Matthias [et al.]. Die Inkunabeln in der Erzbischöflichen Akademischen Bibliothek Paderborn. Wiesbaden, 1993.
Pagnotta	Pagnotta, Linda. Le edizioni italiane della “Legenda aurea” (1475-1630). Firenze, 2005. (Biblioteca di Apax, 1.)
Panzer	Panzer, Georg Wolfgang. Annales typographici ab artis inventae origine ad annum MD … (ad annum MDXXXVI continuati). 11 vols. Norimbergae, 1793-1803.
Paoli(Lucca)	Paoli, Marco. Le edizioni del Quattrocento in una raccolta toscana. Gli incunaboli della Biblioteca Statale di Lucca. 2 vols. Lucca, 1990-92.
Parguez	Parguez, Guy. Catalogues régionaux des incunables des Bibliothèques publiques de France. Vol.XI: Bibliothèques de la Région Rhône-Alpes I: Ain, Ardèche, Loire, Rhône. Paris, 1991.
Parisi	Parisi, Antonio F. Iacottino de Rubeis Tipografo Pinerolese. Pinerolo, 1953.
Pascher	Pascher, Peter Hans. Praktiken des 15. und 16. Jahrhunderts. Klagenfurt, 1980 (Armarium 11).
Pascher(Klagenfurt)	Pascher, Peter Hans. Die Wiegendrucke der Universitätsbibliothek und des Kärntner Landesmuseums in Klagenfurt. Klagenfurt, 1981 (Armarium 7)
Pascher(St.Paul)	Pascher, Peter Hans. Die Einblattdrucke des 15. Jahrhunderts im Stift St.Paul und in den anderen Kärntner Bibliotheken. Klagenfurt, 1981 (Armarium 7).
Pascher(Wiegendrucke)	Pascher, Peter Hans. Die Wiegendrucke in den öffentlichen und privaten Bibliotheken Kärntens. Klagenfurt, 1997 (Armarium 12).
Patriarca	Patriarca, E. Catalogo degli incunabuli della Biblioteca Guarneriana di S. Daniele del Friuli. Udine, 1954.
Paulus, Ablass	Paulus, Nikolaus. Geschichte des Ablasses im Mittelalter. Bd.1-3. Paderborn, 1922-23.
Paulus(Peraudi)	Paulus, Nikolaus. 'Raimund Peraudi als Ablasskommissar'. Historisches Jahrbuch 21 (1900), pp. 645-82.
Pegg	Pegg, Michael A. 'Incunables in the National Library of Scotland: accessions 1946-1966'. Beiträge zur Inkunabelkunde, Dritte Folge 3 (1967) pp.93-106.
Péligry	Péligry, Christian. Catalogues régionaux des incunables des Bibliothèques publiques de France. Vol.III: Bibliothèques de la Région Midi-Pyrénées. Bordeaux, 1982.
Pell	Pellechet, Marie [and M.L. Polain]. Catalogue général des incunables des bibliothèques publiques de France. 3 vols. Nendeln, 1970. (Reproduced from the copy of the original edition (Paris, 1897-1909) annotated by Polain).
Pell Ms	Pellechet, Marie and Polain, M.L. Catalogue général … (MS of unpublished volumes, reproduced from the original now in the Bibliothèque Nationale.) 23 vols. Nendeln, 1970. (The MS number is quoted first, followed by the number added for the printed edition quoted in parentheses except after 10438 (10196), where the MS numeration ceases).
Pell(Lyon)	Pellechet, Marie. Catalogue des incunables des bibliothèques publiques de Lyon. Lyon, 1893. (Nos. 637-1066 appear in the Supplément, by Guy Parguez, Lyon, 1967.)
Pell(V)	Pellechet, Marie. 'Jacques de Voragine: liste des éditions de ses ouvrages publiées au XV. siècle'. Revue des bibliothèques Avril, Août-Septembre, 1895.
Pennink	Pennink, R. Catalogus der niet-Nederlandse drukken: 1500-1540 aanwezig in de Koninklijke Bibliotheek. 's-Gravenhage, 1955.
Pennino	Pennino, Antonio. Catalogo ragionato dei libri di prima stampa e delle edizioni Aldine e rare esistenti nella Biblioteca Nazionale di Palermo. 3 vols. Palermo, 1875-86.
Pfister, Parodien	Pfister, Silvia. Parodien astrologisch-prophetischen Schrifttums 1470-1590: Textformen - Entstehung - Vermittlung - Funktion. Baden-Baden, 1990. (Saecula Spiritalia 22.)
Pforzheimer	The Carl H. Pforzheimer Library. English literature, 1475-1700. [Compiled by Emma V. Unger and William A. Jackson.] New York, 1940.
Picot-Stein	Picot, Émile and Stein, Henri. Recueil de pièces historiques imprimées sous le regne de Louis XI reproduites en facsimile. Paris, 1923.
Pietsch	Pietsch, Paul. Ewangely und Epistel Teutsch. Die gedruckten hochdeutschen Perikopenbücher (Plenarien) 1473 bis 1523 ... . Göttingen, 1927.
PML	Pierpont Morgan Library. Early printed books: major acquisitions of the Pierpont Morgan Library, 1924-1974. New York, [1974].
Polain(B)	Polain, M.-Louis. Catalogue des livres imprimés au quinzième siècle des bibliothèques de Belgique. 5 vols. Bruxelles, 1932-78.
Pollard and Ehrman	Pollard, Graham and Albert Ehrman. The distribution of books by catalogue from the invention of printing to A.D. 1800. Cambridge, 1965.
Poynter	Poynter, F.N.L. A catalogue of incunabula in the Wellcome Historical Medical Library. London, 1964.
Pr	Proctor, Robert. An index to the early printed books in the British Museum from the invention of printing to the year MD, with notes of those in the Bodleian Library. 2 vols. London, 1898. 4 supplements, 1899-1902. (Part II, MDI-MDXX, Germany, London, 1903.)
Pr(G)	Proctor, Robert. The printing of Greek in the fifteenth century. Oxford, 1900. (Illustrated monographs issued by the Bibliographical Society, VIII.)
Pr(T)	Proctor, Robert. Tracts on early printing: I) List of the founts of type and woodcut devices used by the printers of Southern Netherlands in the fifteenth century. London, 1895. II) A note on Eberhard Frommolt of Basel, printer. London, 1895. III) Additions to Campbell's Annales … . London, 1897. (Reprinted in: Bibliographical essays, London, 1905, pp.131-232.)
Probst(Ritualien)	Probst, Manfred. Bibliographie der katholischen Ritualiendrucke des deutschen Sprachbereichs Münster, 1993.
R	Reichling, Dietrich. Appendices ad Hainii-Copingeri Repertorium bibliographicum. Additiones. 6 vols. & index. Monachii, 1905-11.
Rabboni	Antonio Pucci: Cantari di Apollonio di Tiro: edizione crtitica a cura di Renzo Rabboni. Bologna, 1996.
Ravegnani	Ravegnani, G. 'Saggio di un catalogo degli incunabuli della Biblioteca Comunale Ariostea'. Rivista di Ferrara 2 (1934) pp.352-59.
R(Doctr)	Reichling, Dietrich. Das Doctrinale des Alexander de Villa-Dei: kritischexegetische Ausgabe. Berlin, 1893. (Monumenta Germaniae Paedagogica, 12).
Redgr	Redgrave, Gilbert R. Erhard Ratdolt and his work at Venice. London, 1894. (Illustrated monographs issued by the Bibliographical Society, I).
Reininger(Linz)	Reininger, Franz. 'Die Wiegendrucke in der Bibliotheca publica in Linz'. Mitteilungen des Österreichischen Vereins für Bibliothekswesen 13 (1909/1910), pp. 137-79.
Renouard(Badius)	Renouard, Philippe. Bibliographie des impressions et des oeuvres de Josse Badius Ascensius. 3 vols. Paris, 1908.
Renouard, Imprimeurs	Renouard, Philippe. Imprimeurs et libraires parisiens du XVIe siècle. Paris, 1964- [in progress].
Répertoire bibl.	Répertoire bibliographique des livres imprimés en France au seizième siècle. Baden-Baden, 1968-80 (A sub-series, numbered by fascicles, within volumes of the Bibliotheca bibliographica aureliana).
Repgen(Antimanifest)	Repgen, Konrad. 'Aninmanifest und Kriegsmanifest: die Benutzung der neuen Drucktechnik bei der Mainzer Stiftsfehde 1461/63 durch die Erzbischöfe Adolf von Nassau und Diether von Isenburg'. Studien zum 15. Jahrhundert: Festschrift für Erich Meuthen, Bd.2, München, 1994, pp.781-803.
Repgen(Einblattdrucke)	Repgen, Konrad. 'Die politischen Einblattdrucke der Mainzer Stiftfehde in deutscher Sprache (1461/62)'. Archiv für mittelrheinische Kirchengeschichte 46 (1994), pp. 281-321.
Rhodes(Corsten Festschrift)	Rhodes, Dennis E. 'Five undescribed German incunabula in British libraries'. Ars impressoria: eine … Festgabe für Severin Corsten, München, 1986, pp.98-102.
Rhodes(Festschrift)	The Italian book 1465-1800: studies presented to Dennis E. Rhodes … . London, 1993.
Rhodes(Firenze)	Rhodes, Dennis E. Gli annali tipografici fiorentini del XV secolo. Firenze, 1988. (Biblioteca di bibliografia italiana, 113).
Rhodes(Oxford Colleges)	Rhodes, Dennis E. A catalogue of incunabula in all the libraries of Oxford University outside the Bodleian. Oxford, 1982.
Rhodes(Siena)	Rhodes, Dennis E. 'The incunabula of Siena'. Essays in honour of Victor Scholderer, Mainz, 1970, pp.337-48.
Rhodes(Treviso)	Rhodes, Dennis E. La stampa a Treviso nel secolo XV. Treviso, 1983.
Rhodes(Vicenza)	Rhodes, Dennis E. La tipografia nel secolo XV a Vicenza, Santorso e Torrebelvicino. Vicenza, [1987].
Riant	De Germon, L. and Polain, M.-L. Catalogue de la bibliothèque de feu M. le Comte Riant. Deuxième partie, vol.I. Paris, 1899.
Richard	Richard, Hélène. Catalogues régionaux des incunables des Bibliothèques publiques de France. Vol.XIV: Région Poitou Charente- Région Limousin. Paris, 1996.
Ridolfi	Ridolfi, Roberto. La stampa in Firenze nel secolo XV. Firenze, 1958.
Riedl	Riedl, Mirko. Katalog prvotisků jihočeských knihoven (Catalogus incunabulorum quae in bibliothecis Bohemiae meridionalis asservantur). Praha, 1974.
Ritter	Ritter, François. Catalogue des incunables alsaciens de la Bibliothèque Nationale et Universitaire de Strasbourg. Strasbourg, 1938.
Roest	Roest, M. Catalog der Hebraica … aus der L. Rosenthal'schen Bibliothek. 2 vols. Amsterdam, 1875.
Rogledi Manni	Rogledi Manni, Teresa. La tipografia a Milano nel XV secolo. Firenze, 1980. (Biblioteca di bibliografia italiana, 90).
Rogge(Luther)	Rogge, Joachim. Martin Luther: sein Leben, seine Zeit, eine Wirkungen. Berlin, 1982.
Rosenkilde	Rosenkilde, Volmer. Thesaurus librorum danicorum 15th and 16th century. København, 1987.
Rosenwald	The Rosenwald Collection: a catalogue of illustrated books and manuscripts, of books from celebrated presses, and of bindings and maps, 1150-1950. The gift of Lessing J. Rosenwald to the Library of Congress. [Catalogued by Marion Schild; ed. F.R. Goff.] Washington, D.C., 1954.
Rosenwald(EP)	Early printed books of the Low Countries from the Lessing J. Rosenwald Collection. An exhibition in the Library of Congress, April 2, 1958, to August 31, 1958. [Compiled by Frederick R. Goff.] Washington, D.C., 1958.
Rosenwald(F)	The Florentine Fior di Virtu of 1491 translated into English by Nicholas Fersin [i.e. Fersen] with facsimiles of all of the woodcuts. Washington, D.C., 1953. [Concordance of editions printed in the XV century, p.xxiv-xxix, by Lessing J. Rosenwald.]
Rosenwald(1960)	Livres anciens des Pays-Bas: la collection Lessing J. Rosenwald provenant de la bibliothèque d'Arenberg. Exposition … 1960. Bruxelles, 1960.
Rosenwald(1977)	The Lessing J. Rosenwald collection: a catalog of the gifts … to the Library of Congress, 1943 to 1975. Washington, D.C., 1977.
Rossaro	Rossaro, Antonio. Notazione bibliografica degli incunabuli conservati nella Biblioteca Civica G. Tartarotti di Rovereto. Reggio d'Emilia, 1935.
Rouse, Cartolai	Rouse, Mary A. and Richard H. Cartolai, illuminators, and printers in fifteenth-century Italy: the evidence of the Ripoli Press. Los Angeles, 1988.
(R)STC	A short-title catalogue of books printed in England, Scotland and Ireland 1475-1640. First compiled by A.W. Pollard and G.R. Redgrave. 2nd edition. 3 vols. London, 1976-91.
R(Suppl)	Reichling, Dietrich. Appendices ad Hainii-Copingeri Repertorium Bibliographicum: additiones et emendationes. Supplement. Monasterii, 1914.
Ruppel	Ruppel, Aloys. Johannes Gutenberg. Sein Leben und sein Werk. Nieuwkoop, 1967.
Saam	Saam, Dieter. Albrecht Kunne aus Duderstadt. Der Prototypograph von Trient und Memmingen und die Produktion seiner Offizinen (ca. 1474 bis 1520). Freiburg i.Br., 1990.
Sack(Freiburg)	Sack, Vera. Die Inkunabeln der Universitätsbibliothek und anderer öffentlicher Sammlungen in Freiburg im Breisgau und Umgebung. 3 vols. Wiesbaden, 1985.
Sajó-Soltész	Sajó, Géza and Soltész, Erszébet. Catalogus incunabulorum quae in bibliothecis publicis Hungariae asservantur. 2 vols. Budapestini, 1970.
Sallander	Sallander, Hans. Katalog der Inkunabeln der Kgl. Universitäts-Bibliothek zu Uppsala. 1) Neuerwerbungen seit dem Jahre 1907. Uppsala, 1953. (Bibliotheca Ekmaniana, 59). 2) Neuerwerbungen der Jahre 1954-64. Uppsala, 1965. (Bibliotheca Ekmaniana, 63).
Salvá	Salvá y Mallén, Pedro. Catálogo de la biblioteca de Salvá. 2 vols. Valencia, 1872.
Sánchez	Sánchez, Juan Manuel. Bibliografía Zaragozana del siglo XV, por un bibliófilo Aragonés. Madrid, 1908.
Sander	Sander, Max. Le livre à figures italien depuis 1467 jusqu'en 1530: essai de sa bibliographie et de son histoire. 6 vols. New York, 1941.
Sangsprüche und Meisterlieder	Repertorium der Sangsprüche und Meisterlieder des 12. bis 18. Jahrhunderts. 16 vols. Tübingen, 1994-2002.
Santoro	Santoro, C. Libri illustrati milanesi del Rinascimento. Milano, 1956.
Scapecchi(M)	Scapecchi, Piero. Catalogo incunaboli [Biblioteca Marucelliana, Firenze]. Roma, 1989.
Schäfer	Arnim, Manfred von. Katalog der Bibliothek Otto Schäfer, Schweinfurt. Teil I: Drucke, Manuskripte und Einbände des 15. Jahrhunderts. Stuttgart, 1984.
Schanze(Buchdruck)	Schanze, Frieder. 'Der Buchdruck eine Medienrevolution'. Mittelalter und frühe Neuzeit: Übergänge, Umbrüche und Neuansätze, Tübingen, 1999, pp.286-311. (Fortuna Vitrea, Bd.16).
Schanze(Gb Jb 1994)	Schanze, Frieder. 'Der Drucker des Breviarium Ratisponense (?Georgius de Spira)'. Gb Jb 69 (1994), pp. 67-77.
Schanze(Inkunabelgrenze)	Schanze, Frieder. 'Inkunabeln oder Postinkunabeln? Zur Problematik der Inkunabelgrenze am Beispiel von 5 Druckern und 111 Einblattdrucken'. Einblattdrucke des 15. und frühen 16. Jahrhunderts: Probleme, Perspektiven, Fallstudien, Tübingen, 2000, pp.45-122
Schanze(Liedkunst)	Schanze, Frieder. Meisterliche Liedkunst zwischen Heinrich von Mügeln und Hans Sachs. 2 vols. München, 1983-84. 
Schanze(Romweg-Karte)	Schanze, Frieder. 'Zu Erhard Etzlaubs Romweg-Karte, dem Drucker Kasper Hochfeder in Nürnberg und einem unbekannten Nürnberger Drucker in der Nachfolge Hochfeders'. Gb Jb 1996, pp. 126-40.
Schilling	Schilling, F. Die Wiegendrucke in Coburg. Coburg, 1954.
Schmidt	Schmidt, Charles. Répertoire bibliographique strasbourgeois jusque vers 1530. 8 parts. Strasbourg, 1893-96.
Schmidt(Denkmale)	Schmidt, Wilhelm. Die frühesten und seltensten Denkmale des Holz- und Metallschnittses aus dem vierzehnten und fünfzehnten Jahrhundert nach den Originalen im k. Kupferstich-Cabinet und in der k. Hof- und Staatsbibliothek in München durch Lichtdruck als Facsimiles reproduziert. Nürnberg, 1883.
Schmidt(Lippische Ablassbriefe)	Schmidt, Adolf. 'Lippische Ablaßbriefe'. Beiträge zum Bibliotheks- und Buchwesen, Paul Schwenke zum 20.März 1913 gewidmet, Berlin, 1913, pp. 227-33.
Schmitt	Schmitt, Anneliese. 'Die Inkunabeln der Deutschen Staatsbibliothek zu Berlin im Anschluss an Ernst Voulliéme. I) Katalog der in der Deutschen Staatsbibliothek zu Berlin vorhandenen Inkunabeln. II) Die Inkunabeln der Preussischen Staatsbibliothek: Neuerwerbungen der Jahre 1927-45'. Beiträge zur Inkunabelkunde, Dritte Folge 2 (1966).
Schmitt & Knox	Schmitt, Charles, and Dilwyn Knox. Pseudo-Aristoteles Latinus: a guide to Latin works falsely attributed to Aristotle before 1500. London, 1985.
Schmitz	Schmitz, Wolfgang. Die Kölner Einblattdrucke des 15. Jahrhunderts. Köln, 1979.
Scholderer(Aberystwyth)	Scholderer, Victor. 'Hand-list of incunabula in the National Library of Wales'. National Library of Wales Journal Supplement, ser. 1 no. 1 (1940). Addenda & corrigenda. NLW Journal Supplement, ser. 1 no. 2 (1941).
Schorbach	Schorbach, Karl. Der Strassburger Frühdrucker Johann Mentelin (1458-1478): Studien zu seinem Leben und Werke. Mainz, 1932.
Schorbach and Spirgatis	Schorbach, Karl and Spirgatis, Max. Heinrich Knoblochtzer in Strassburg (1477-1484). Strassburg, 1888.
Schottenloher(Buchdruckerkunst)	Schottenloher, Karl. Die Entwicklung der Buchdruckerkunst in Franken bis 1530. Würzburg, 1910. (Neujahrsblätter herausgegeben von der Gesellschaft für Fränkische Geschichte, Vol. 5)
Schottenloher(Buchgewerbe)	Schottenloher, Karl. Das Regensburger Buchgewerbe im 15. und 16. Jahrhundert. Mainz, 1920. (Veröffentlichungen der Gutenberg-Gesellschaft, Vols. 14-19).
Schottenloher(Druckwerke)	Schottenloher, Karl. Die liturgischen Druckwerke Erhard Ratdolts aus Augsburg 1485-1522: Typen- und Bildproben. Mainz, 1922. (Veröffentlichungen der Gutenberg-Gesellschaft, Sonderband 1).
Schottenloher(Flugblatt)	Schottenloher, Karl. Flugblatt und Zeitung: ein Wegweiser durch das gedruckte Tagesschrifttum. Berlin, 1922 (Bibliothek für Kunst- und Antiquitätensammler, Vol. 21).
Schottenloher(Schobser)	Schottenloher, Karl. Der Münchner Buchdrucker Hans Schobser 1500-1530. München, 1925. (Reprinted Nieuwkoop, 1967.)
Schr	Schreiber, Wilhelm Ludwig. Manuel de l'amateur de la gravure sur bois et sur métal au XVe siècle. Tom. 5: Un catalogue des incunables à figures imprimés en Allemagne, en Suisse, en Autriche-Hongrie et Scandinavie. 2 parts. Leipzig, 1910-11.
Schr(Handbuch)	Schreiber, Wilhelm Ludwig. Handbuch der Holz- und Metallschnitte des XV. Jahrhunderts. 8 vols. Leipzig, 1926-30.
Schramm	Schramm, Albert. Der Bilderschmuck der Frühdrucke, fortgeführt von der Kommission für den Gesamtkatalog der Wiegendrucke. 23 vols. Leipzig, 1920-43.
Schubert, Olmütz	Schubert, Anton. Die Wiegendrukke der Studienbibliothek zu Olmütz vor 1501. Olmütz, 1901.
Schudt	Schudt, Ludwig. Le Guide di Roma: Materialien zu einer Geschichte der römischen Topographie. Wien, Augsburg, 1930.
Schüling	Schüling, Hermann. Die Inkunabeln der Universitätsbibliothek Giessen. Giessen, 1966.
Schüling(Renchen)	Schüling, Joachim. Der Drucker Ludwig von Renchen und seine Offizin: ein Beitrag zur Geschichte des Kölner Buchdrucks. Wiesbaden, 1992. (Buchwissenschaftliche Beiträge aus dem Deutschen Bucharchiv München, Vol. 41).
Schullian	Schullian, Dorothy M. and Sommer, Frances E. A catalogue of incunabula and manuscripts in the Army Medical Library. New York, [1948?].
Schwab	Schwab, Moïse. Les incunables orientaux … . Paris, 1883.
Schwenke, DK-Type	Schwenke, Paul. Die Donat- und Kalender-Type, mit einem Abdruck des Donattextes nach den ältesten Ausgaben. Mainz 1902. (Veröffentlichungen der Gutenberg-Gesellschaft, II).
Seguin(Charles VIII)	Seguin, Jean-Pierre. 'L'information à la fin du XVe siècle en France. Pièces d'actualité imprimées sous le règne de Charles VIII'. Arts et traditions populaires 1956 no.4 pp.309-30; 1957 no.1 pp.46-74.
Seguin(Louis XII)	Seguin, Jean Pierre. L'information en France de Louis XII à Henri II. Genève, 1961.
Sélestat	Walter, Joseph. Ville de Sélestat: catalogue général de la Bibliothèque Municipale. Pt. 3: Incunables & XVIme siècle. Colmar, 1929.
Serra Zanetti	Serra Zanetti, Alberto. L'arte della stampa in Bologna nel primo ventennio del Cinquecento. Bologna, 1959.
Shaw(Jena)	Shaw, David J. 'Unrecorded French incunables in the Thüringer Universitäts- und Landesbibliothek Jena'. The Library ser.6,19 (1997) pp.197-220.
Sheppard	Sheppard, L.A. Catalogue of XVth century books in the Bodleian Library. [Unpublished MS, 1954-71].
Sinker	Sinker, Robert. A catalogue of the fifteenth-century printed books in the library of Trinity College, Cambridge. Cambridge, 1876.
Slenczka	Slencka, Ruth. Lehrhafte Bildtafeln in spätmittelalterlichen Kirchen. Köln/Weimar/Wien, 1998. (Pictura et Poesis, Vol. 10).
Smith(RaraAr)	Smith, David Eugene. Rara arithmetica: a catalogue of the arithmetics written before the year MDCI with a description of those in the library of George Arthur Plimpton. Boston and London, 1908.
Sorbelli, Azzoguidi	Sorbelli, A. I primordi della stampa in Bologna: Baldassarre Azzoguidi. Bologna, 1908.
Speck(Petrarca)	Francesco Petrarca 1304-1374: Werk und Wirkung im Spiegel der Biblioteca Petrarchesca Reiner Speck. Köln, 2004.
Spital(Ritualien)	Spital, Hermann Josef. Der Taufritus in den deutschen Ritualien von den ersten Drucken bis zur Einführung des Rituale Romanum. Münster, 1968 (Bibliographie der Ritualien pp. 212-84).
St	Steinschneider, Moritz. Catalogus librorum hebraeorum in Bibliotheca Bodleiana. 3 vols. Berolini, 1852-60.
St Gallen	Scherrer, Gustav. Verzeichniss der Incunabeln der Stiftsbibliothek von St. Gallen. St. Gallen, 1880.
Stevenson-Briquet	Briquet, C.M. Les Filigranes ... A facsimile of the 1907 edition with supplementary material contributed by a number of scholars. Edited by Allan Stevenson. 4 vols. Amsterdam, 1968.
STC	Pollard, A.W. and Redgrave, G.R. A short-title catalogue of books printed in England, Scotland, & Ireland and of English books printed abroad 1475-1640. London, 1926.
Stillwell	Stillwell, Margaret Bingham. Incunabula in American libraries: a second census. New York, 1940.
Stillwell, Beginning	Stillwell, Margaret Bingham. The beginning of the world of books 1450-1470. New York, 1972.
Stillw(FT)	Stillwell, Margaret B. 'The Fasciculus Temporum, a genealogical survey of editions before 1480'. Bibliographical essays, a tribute to Wilberforce Eames, Cambridge (Mass.), 1924, pp.409-40.
Stuttgart(Dt.Bibel)	'Deutsche Bibeldrucke 1466-1600'. Die Bibelsammlung der Württembergischen Landesbibliothek Stuttgart, Zweite Abt., 1. Bd. Stuttgart, 1987.
Stuttgart(Lat.Bibel)	'Lateinische Bibeldrucke 1454-1564'. Die Bibelsammlung der Württembergischen Landesbibliothek Stuttgart, Erste Abt., 4. Bd., 1.Teil. Stuttgart, 2002.
Suckow(Koch)	Suckow, Ninon. 'Der Magdeburger Frühdrucker Simon Koch: zur Überlieferung seiner Druckproduktion'. Inkunabel- und Einbandkunde: Beiträge des Symposions zu Ehren von Max Joseph Husung am 17. und 18. Mai 1995 in Helmstedt, Wiesbaden, 1996, pp. 87-94 (Bibliothek und Wissenschaft 29 (1996).
Sudhoff	Sudhoff, Karl. Deutsche medizinische Inkunabeln. Leipzig, 1908.
Sudhoff(Erstlinge)	Sudhoff, Karl. Graphische und typographische Erstlinge der Syphilisliteratur aus den Jahren 1495 und 1496. München, 1912 (Alte Meister der Medizin und Naturkunde, Bd. 4).
Tchemerzine	Tchemerzine, Avenir. Bibliographie d'éditions originales ou rares d'auteurs français des XVe, XVIe, XVIIe et XVIIIe siècles. 10 vols. Paris, 1930-36.
Teitge-Stelzer	Teitge, Hans-Erich und Eva-Maria Stelzer (ed.). Kostbarkeiten der Deutschen Staatsbibliothek. Leipzig, 1986.
Tenschert(Horae)	Horae B.M.V.: 158 Stundenbuchdrucke der Sammlung Bibermühle. Hrsg. Heribert Tenschert und Ina Nettekoven. Ramsen, 2003.
TFS	Type Facsimile Society. Publications. Oxford, 1900-09.
Thach	Ashley, Frederick W. Library of Congress: Catalogue of the John Boyd Thacher collection of incunabula. Washington, D.C., 1915.
Thes	Thesaurus typographiae hebraicae saeculi XV. Edited by Aron Freimann. Parts 1-8. Berlin, 1924-31.
Thierry-Poux	Thierry-Poux, Olgar. Premiers monuments de l'imprimerie en France au XVe siècle. Paris, 1890.
Tinto	Tinto, Alberto. Gli annali tipografici di Eucario e Marcello Silber (1501-1527). Firenze, 1968. (Biblioteca di bibliografia italiana, 55).
Tobolka	Tobolka, Zdeněk. Český slovník bibliografický. Díl I. České prvotisky, až do r. 1500. Prague, 1910.
Torchet	Torchet, Louis. Catalogues régionaux des incunables des Bibliothèques publiques de France. Vol.V: Bibliothèques de la Région des Pays de la Loire. Bordeaux, 1987.
Überlingen	Überlinger Inkunabelkatalog: Katalog der Inkunabeln der Leopold-Sophien-Bibliothek Überlingen. Bearbeitet von D.H. Stolz. Konstanz, 1970.
Urbánková	Urbánková, Emma. Soupis prvotisků českého původu. Praha, 1986.
Valsecchi	Valsecchi, F. Gli incunaboli dell' Ambrosiana. Vol.1. Vicenza, 1972.
Valverde	Valverde del Barrio, Cristino. Catálogo de incunables y libros raros de la Santa Iglesia Catedral de Segovia. Segovia, 1930.
Van der Haegen	Van der Haegen, Pierre L. Der frühe Basler Buchdruck. Basel, 2001 (Schriften der Universitätsbibliothek Basel, Vol. 5)
Van der Vekene	Van der Vekene, Emil. Katalog der Inkunabeln der Nationalbibliothek Luxemburg. Luxemburg, 1970.
Van der Vekene(Hochfeder)	Van der Vekene, Emil. Kaspar Hochfeder. Baden-Baden, 1974. (Bibliotheca Bibliographica aureliana, 52).
Van Straalen	Van Straalen, S. Catalogue of Hebrew books in the British Museum acquired during the years 1868-92. London, 1894.
VD16	Verzeichnis der im deutschen Sprachbereich erschienenen Drucke des XVI. Jahrhunderts. Stuttgart, 1983- 1997.
VE15	Eisermann, Falk. Verzeichnis der typographischen Einblattdrucke des 15. Jahrhunderts im Heiligen Römischen Reich Deutscher Nation. 3 vols. Wiesbaden, 2004.
Veneziani(Brescia)	Veneziani, Paolo. La tipografia a Brescia nel XV secolo. Firenze, 1986. (Biblioteca di bibliografia italiana, 107).
Veneziani(Perugia)	Veneziani, Paolo. 'Pietro da Colonia e il Tipografo del Robertus Anglicus'. La Bibliofilia 75 (1973) pp.45-75.
Veneziani(Roma)	Veneziani, Paolo. 'Cinque incunabuli romani sconosciuti'. Annali della Scuola speciale per archivisti e bibliotecari dell' Università di Roma 13 (1973) pp.70-81.
Verdier(Talleur)	Verdier, Pierre Le. L'atelier de Guillaume Le Talleur. Rouen, 1916.
Verfasserlexikon 2	Die deutsche Literatur des Mittelalters. Verfasserlexikon. 2. völlig neu bearb. Auflage. Berlin, 1978- [in progress].
Veyrin-Forrer(Cesaris)	Veyrin-Forrer, Jeanne. 'Le deuxième atelier typographique de Paris: Cesaris et Stol'. Gb Jb 1976 pp.117-29 (reprinted in: La lettre et le texte, Paris, 1987, pp.189-212).
Veyrin-Forrer(Premiers ateliers)	Veyrin-Forrer, Jeanne. 'Les premiers ateliers typographiques parisiens: quelques aspects techniques'. Villes d'imprimerie et moulins à papier du XIVe au XVIe siècle: colloque international, Spa, 11-14.IX.1973, Bruxelles, 1976, pp.317-35 (reprinted in: La lettre et le texte, Paris, 1987, pp.213-36).
Veyrin-Forrer(Sorbonne)	Veyrin-Forrer, Jeanne. 'Aux origines de l'imprimerie française: l'atelier de la Sorbonne et ses mecènes'. L'art du livre à l'Imprimerie Nationale, Paris, 1973, pp.32-53 (reprinted in: La lettre et le texte, Paris, 1987, pp.161-88).
Vindel	Vindel, Francisco. Manual gráfico-descriptivo del bibliófilo Hispano-Americano (1475-1850). Suplemento. Madrid, 1934.
Vindel(A)	Vindel, Francisco. El arte tipográfico en España durante el siglo XV. 9 vols. Madrid, 1945-51.
Vischer(Zürich)	Vischer, Manfred. Bibliographie der Zürcher Druckschriften des 15. und 16. Jahrhunderts. Baden-Baden, 1991. (Bibliotheca Bibliographica Aureliana, 124.)
Voull(B)	Voulliéme, Ernst. Die Inkunabeln der Königlichen Bibliothek (Preussischen Staatsbibliothek) und der anderen Berliner Sammlungen. XXX. Beiheft zum ZfB. Leipzig, 1906. (supplements: 1914, 1922, 1927).
Voull(Bonn)	Voulliéme, Ernst. Die Incunabeln der Königlichen Universitäts-Bibliothek zu Bonn. XIII. Beiheft zum ZfB. Leipzig, 1894.
Voull(K)	Voulliéme, Ernst. Der Buchdruck Kölns bis zum Ende des fünfzehnten Jahrhunderts. Bonn, 1903. (Gesellschaft für Rheinische Geschichtskunde, XXIV).
Voull(Nachträge)	Voulliéme, Ernst. 'Nachträge zu den Buchhändleranzeigen des XV. Jahrhunderts in getreuen Nachbildungen herausgegeben von K. Burger', Festgabe Konrad Haebler, pp.18-44.
Voull(Trier)	Voulliéme, Ernst. Die Inkunabeln der öffentlichen Bibliothek und der kleineren Büchersammlungen der Stadt Trier. XXXVIII. Beiheft zum ZfB. Leipzig, 1910.
Voull(1904)	Voulliéme, Ernst. 'Unbeschriebene niederländische Inkunabeln der Berliner Königlichen Bibliothek'. ZfB 21 (1904) pp.439-50.
Wach	Wachstein, B. Katalog der Salo Cohn'schen Schenkungen. II: Bücher aus der Sammlung S.H. Halberstam. Wien. 1914.
Wäscher(Flugblatt)	Wäscher, Hermann. Das deutsche illustrierte Flugblatt von den Anfängen bis zu den Befreiungskriegen. Dresden, 1955.
Wagner & Carrera	Wagner, K. and M. Carrera. Catalogo dei libri a stampa in lingua italiana della Biblioteca Colombina di Siviglia. Modena, 1991.
Walsh	Walsh, James E. A catalogue of the fifteenth-century printed books in the Harvard University Library. 5 vols. Binghamton NY, Tempe AZ, 1991-95. (supplement ... , by David R. Whitesell. Harvard Library Bulletin 16 nos. 1-2 (2005)).
Walt	Incunabula typographica: a descriptive catalogue of the books printed in the fifteenth century (1460-1500) in the library of Henry Walters. Baltimore, 1906.
Weale	Weale, W.H. James. Bibliographia liturgica: catalogus missalium ritus latini ab anno M.CCCC.LXXV. impressorum. Londini, 1886.
Weale-Boh	Bibliographia liturgica … : Iterum edidit H. Bohatta. Londini, 1928.
Weale-Boh(Suppl)	Amiet, Robert. Missels et bréviaires imprimés (supplément aux catalogues de Weale et Bohatta). Paris, 1990.
Wehmer(Buchdrucker)	Wehmer, Carl, Deutsche Buchdrucker des fünfzehnten Jahrhunderts. Wiesbaden, 1971 (Reprinted from: Wehmer, Carl, Deutscher Buchdruck im Jahrhundert Gutenbergs. Leipzig, 1940).
Weil(München)	Weil, Ernst. Die Wiegendrucke Münchens: ein bibliographisches Verzeichnis mit neun Typentafeln. München, 1923.
Weller	Weller, Emil. Repertorium bibliographicum: die deutsche Literatur im ersten Viertel des 16.Jahrhunderts. Nördlingen, 1864. (Reprinted Hildesheim, 1961).
Well(Pl)Cat	Jackson, Margaret Hastings. Catalogue of the Frances Taylor Pearsons Plimpton collection of Italian books … in the library of Wellesley College. Cambridge (Mass.), 1929.
Wickersheimer	Wickersheimer, E. Dictionnaire biographique des médecins en France au Moyen Age. Genève, 1936. (Supplément, par Danielle Jacquart. Genève, 1979.)
Wiegrefe	Wiegrefe, A. W. Die Wiegendrucke der Oberschule für Jungen in Stadthagen. [Bückeburg, 1940.] (Sonderdruck aus der Festschrift 'Das Alte Stadthagen und seine Höhere Schule'. Bückeburg, 1939.)
Wiener	Wiener, S. Catalogus librorum impressorum hebraeorum in Museo Asiatico Scientiarum Rossicae asservatorum. Petropoli, 1893-1936.
WILC	Watermarks in incunabula printed in the Low Countries. http://watermark.kb.nl/index.html.
Wilhelmi	Wilhelmi, T. Inkunabeln in Greifswalder Bibliotheken: Verzeichnis der Bestände der Universitätsbibliothek Greifswald, der Bibliothek des Geistlichen Ministeriums und des Landesarchivs Greifswald. Wiesbaden, 1997.
Wilhelmi, Brant	Wilhelmi, T. Sebastian Brant Bibliographie. Bern u.a., 1990. (Arbeiten zur mittleren Deutschen Literatur und Sprache, 18/3).
Will	Will, Erich. Decreti Gratiani incunabula. Bononiae, 1959. (Studia Gratiana, 6).
Wilson	Wilson, Adrian. The making of the Nuremberg Chronicle. Amsterdam, 1976.
Winn(Vérard)	Winn, Mary Beth. Anthoine Vérard: Parisian publisher 1485-1512. Genève, 1997. (Travaux d'humanisme et renaissance, 313).
Winteroll	Winteroll, Hans Michael. Summae Innumerae: die Buchanzeigen der Inkunabelzeit und der Wandel lateinischer Gebrauchstexte im frühen Buchdruck. Stuttgart, 1987. (Stuttgarter Arbeiten zur Germanistik, 193.)
Wuttke(Donnerstein)	Wuttke, Dieter. 'Sebastian Brant und Maximilian I: eine Studie zu Brants Donnerstein-Flugblatt des Jahres 1492', Die Humanisten in ihrer politischen und sozialen Umwelt, Boppard, 1976, pp.141-76. (Deutsche Forschungsgemeinschaft. Kommission für Humanismusforschung. Mitteilung III).
Yhmoff Cabrera	Yhmoff Cabrera, Jesús. Catálogo de incunables de la Biblioteca Nacional de México. 2a ed. México, 1987.
Zámecké knihovny	Katalog prvotisků zámeckých a hradních knihoven v České republice. Část 1-4: Sborník Národního Muzea v Praze, Rada C, 33.3-4 (1988), 34 (1989), 35 (1990, with plates).
ZD	Hermans, Jos. M. M. Zwolse boeken voor een markt zonder grenzen 1477-1523. 't Goy-Houten, 2004.
Zdanevich	Zdanevich, B. Katalog inkunabul. [Akademiya Nauk Ukrains'koi RSR]. Kiev, 1974.
Zedler(Ablassbriefe)	Zedler, Gottfried. Die Mainzer Ablaßbriefe der Jahre 1454 und 1455. Mainz, 1913. (Veröffentlichungen der Gutenberg-Gesellschaft, Bd.12/13).
Zedler(Nassau)	Zedler, Gottfried. Die Inkunabeln Nassauischer Bibliotheken. Wiesbaden, 1900.
Zedler, Pfister	Zedler, Gottfried. Die Bamberger Pfisterdrucke. Mainz, 1911. (Veröffentlichungen der Gutenberg-Gesellschaft X-XI).
Zedner	Zedner, J. Catalogue of the Hebrew books in the library of the British Museum. London, 1867.
Zehnacker	Zehnacker, Françoise. Catalogues régionaux des incunables des Bibliothèques publiques de France. Vol.XIII: Région Alsace (Bas Rhin). Tome 1.2. Paris, 1997.
ZfB	Zentralblatt für Bibliothekswesen. Leipzig, 1884-1990. (From 1884 to 1903 'Centralblatt … ').
ZfBB	Zeitschrift für Bibliothekswesen und Bibliographie. Frankfurt am Main, 1954- .
Zilioli	Zilioli Faden, Rosa. Catalogo del Fondo Lanfranchi della Biblioteca Civica di Pallazzolo sull'Oglio. I. Gli incunaboli e i manoscritti. Milano, 1996.
Zimmer	Zimmer, Szczepan K. The beginning of Cyrillic printing: Cracow, 1491. New York, 1973.
Zinner	Zinner, Ernst. Geschichte und Bibliographie der astronomischen Literatur in Deutschland zur Zeit der Renaissance. 2. Aufl. mit einem Nachtrag von 622 Nummern. Stuttgart 1964.
Zoepfl	Zoepfl, Friedrich. Das Bistum Augsburg und seine Bischöfe im Mittelalter. Augsburg, 1955.
