AASL	American Antiquarian Society, Worcester MA
AB(NY)L	Association of the Bar of the City of New York, New York NY
ABSL	Museum of Biblical Art, American Bible Society Collection, New York NY
AICL	Art Institute of Chicago, Chicago IL
AlCL	Albion College, Albion MI
AllCLL	Allegheny County Law Library, Pittsburgh PA
AlvCL	Alverno College, Milwaukee WI
AmBML	Brown Univ., Annmary Brown Memorial Collection, Providence RI
AmCL	Amherst College, Amherst MA
ANTSL	Andover Newton Theological School, Newton Centre MA
APSL	American Philosophical Society, Philadelphia PA
ArizUL	Univ. of Arizona Library, Tucson AZ
ASCL	Arizona State Univ., Matthews Library, Tempe AZ
AthOhL	Athenaeum of Ohio, Mt St Mary's Seminary, Cincinnati OH
AubUL	Auburn Univ. Library, Auburn AL
AugCL	Augustana College, Denkmann Memorial Library, Rock Island IL
AUnL	American Univ., Washington DC
AusCL	Austin College, Sherman TX
BACL	Belmont Abbey College Library, Belmont NC
BakL	Bakken Library of Electricity in Life, Minneapolis MN
BanPL	Bangor Public Library, Bangor ME
BAthL	Boston Athenaeum, Boston MA
BaUL	Baker Univ. Library, Baldwin KS
BaSUL	Ball State Univ., Alexander M. Bracken Library, Muncie IN
BayUL	Baylor Univ., Moody Library, Waco TX
BCCL	Book Club of California Library, San Francisco CA
BColL	Boston College Library, Chestnut Hill MA
BCol(L)L	Boston College Law Library, Newton Center MA
BECPL	Buffalo and Erie County Public Library, Buffalo NY
BerCL	Berea College Library, Berea KY
BexCML	Univ. of Texas Health Sciences Center, Briscoe Library, San Antonio TX
BMawrCL	Bryn Mawr College, Goodhart Medieval Library, Bryn Mawr PA
BMSL	Buffalo Museum of Science (Buffalo Society of Natural Sciences), Buffalo NY
BostUL	Boston Univ., Mugar Memorial Library, Boston MA
BowCL	Bowdoin College, Brunswick ME
BPubL	Boston Public Library, Boston MA
BrandUL	Brandeis Univ. Library, Waltham MA
BrAthCL	Bryn Athyn College Library, Bryn Athyn PA
BrCL	Brooklyn College Library, Brooklyn NY
BrUL	Brown Univ., John Hay Library, Providence RI
BSUL	Boise State Univ. Library, Boise ID
BuCHSL	Bucks County Historical Society, Doylestown PA
BUMCL	Baylor Univ. Medical Center (R. & L. Sellers Coll.), Dallas TX
ButUL	Butler Univ., Indianapolis IN
BYUL	Brigham Young Univ., Provo UT
CAbL	Conception Abbey Library, Conception MO
CalSUNL	California State Univ., Northridge, Library, Northridge CA
CAML	Cincinnati Art Museum Library, Cincinnati OH
CanCL	Canisius College, Buffalo NY
CapCL	Capuchin College, Washington DC
CarFL	Carthusian Foundation, Arlington VT
CarL	Carnegie Library of Pittsburgh, Pittsburgh PA
CBGTU	Graduate Theological Union, Berkeley CA
CBPac	Pacific School of Religion, Howell Bible Collection, Berkeley CA
CC(NY)L	The City College, New York NY
CCL	Connecticut College, New London CT
CdelCL	La Casa del Libro, San Juan PR
ChapUL	Chapman Univ., Orange CA
ChiBGL	Chicago Botanic Garden, Glencoe IL
ChiPL	Chicago Public Library, Chicago IL
ChiTSL	Chicago Theological Seminary, Chicago IL
ChL	Williams College, Chapin Library, Williamstown MA
CHPL	Carl H. Pforzheimer Library, The Carl and Lily Pforzheimer Foundation, Inc., New York NY
ChSHL	Church of the Sacred Heart, Province of St Joseph of the Capuchin Order of New York, Yonkers NY
CIAL	Clark Institute of Art Library, Williamstown MA
CinPL	The Public Library of Cincinnati and Hamilton County, Cincinnati OH
CleMedL	Case Western Reserve Univ., Dittrick Medical History Center, Cleveland Medical Library Association, Cleveland OH
CleML	Cleveland Museum of Art, Cleveland OH
ClePL	Cleveland Public Library, Cleveland OH
ClUL	Clark Univ. Library, Worcester MA
CMU(H)L	Carnegie Mellon Univ., Hunt (Botanical) Collection, Pittsburgh PA
CMU(P)L	Carnegie Mellon Univ., Posner Memorial Collection, Pittsburgh PA
CMUL	Carnegie Mellon Univ., Pittsburgh PA
ColCL	Colby College, Waterville ME
ColgUL	Colgate Univ. Library, Hamilton NY
ColoCL	Colorado College, Coburn Library, Colorado Springs CO
ColoSL	Colorado State University Libraries, Special Collections, Fort Collins CO
ColSL	Franciscan Univ. of Steubenville, Steubenville OH
ColUL	Columbia Univ., Butler Library, New York NY
ColU(A)L	Columbia Univ., Avery Library, New York NY
ColU(L)L	Columbia Univ., Law Library, New York NY
ColU(M)L	Columbia Univ., Health Sciences Library, New York NY
ColU(P)L	Columbia Univ., Plimpton Library, New York NY
ColU(T)L	Columbia Univ., Teachers College, New York NY
ColWL	College of Wooster, Wooster OH
ConCL	Concordia Univ. Wisconsin, Mequon WI
ConHSL	Concordia Historical Institute, St Louis MO
ConSL	Concordia Seminary, Pritzlaff Memorial Library, St Louis MO
ConStL	Connecticut State Library, Hartford CT
CorMGL	Corning Museum of Glass, Corning NY
CornUL	Cornell Univ. Libraries, Ithaca NY
COSA	St Albert's Priory, Oakland CA
CPhL	College of Physicians of Philadelphia, Philadelphia PA
CrPL	Crandall Public Library, Glens Falls NY
CreigUL	Creighton Univ. Library, Omaha NE
CS(Su)L	California State Library, Sutro Branch, San Francisco CA
Csat	San Francisco Theological Seminary, San Anselmo CA
CSL	California State Library, Sacramento CA
CStCL	College of St Catherine, St Paul MN
CStTL	Univ. of St Thomas, St Paul MN
CTSL	Concordia Theological Seminary, Fort Wayne IN
CUAL	Catholic Univ. of America, Washington DC
DalPL	Dallas Public Library, Dallas TX
DarCL	Dartmouth College, Rauner Special Collections Library, Hanover NH
DayUL	Univ. of Dayton, Dayton OH
DenPL	Denver Public Library, Denver CO
DenUL	Denison Univ., Granville OH
DePUL	DePaul Univ. Libraries, Chicago IL
DetPL	Detroit Public Library, Detroit MI
DHS(W)L	Dominican House of Studies, Dominican College Library, Washington, DC
DIAL	Detroit Institute of Arts, Detroit MI
DickCL	Dickinson College Library, Carlisle PA
DrexIL	Drexel Univ., Philadelphia PA
DrUL	Drew Univ., Rose Memorial Library, Madison NJ
DruryUL	Drury Univ., Springfield MO
DTSL	Dallas Theological Seminary, Mosher Library, Dallas TX
DuqUL	Duquesne Univ. Library, Pittsburgh PA
DuU(M)L	Duke Univ. Medical Center Library, Durham NC
DuUL	Duke Univ. Library, Durham NC
ECl(NY)L	The Explorers Club, New York NY
EDSL	Episcopal Divinity School, Cambridge MA
EHFL	East Hampton Free Library, East Hampton NY
ElmCL	Elmira College Library, Elmira NY
EMHL	Eleutherian Mills Historical Library, Hagley Museum, Wilmington DE
EMichUL	Eastern Michigan Univ. Library, Ypsilanti MI
EPFL	Enoch Pratt Free Library, Baltimore MD
EUL	Emory Univ. Library, Atlanta GA
FandMCL	Franklin and Marshall College, Fackenthal Library, Lancaster PA
FDRL	Franklin D. Roosevelt Library, Hyde Park NY
FDUL	Fairleigh Dickinson Univ. Library, Madison NJ
FF(SB)L	Franciscan Fathers, Santa Barbara CA
FIL	St Bonaventure Univ., Franciscan Institute, St Bonaventure NY
FMC(R)L	Friars Minor Conventuals, Rensselaer NY
FML	Franciscan Monastery Library, Washington DC
FolgSL	Folger Shakespeare Library, Washington DC
FordUL	Fordham Univ. Library, New York NY
FrankIL	Franklin Institute, Philadelphia PA
FSCL	California State Univ., Fresno CA
FSUL	Florida State Univ. Library, Tallahassee FL
GanUL	Gannon Univ. Library, Erie PA
GCL	Getty Research Institute, Getty Centre, Los Angeles CA
GeM	Getty Museum, Dept. of Manuscripts, Los Angeles CA
GetCL	Gettysburg College Library, Gettysburg PA
GethAL	Our Lady of Gethsemani Abbey, Trappist KY
GeUL	Georgetown Univ., Washington DC
GEvTSL	Garrett-Evangelical Theological Seminary Library, Evanston IL
GHSL	Georgia Historical Society, Savannah GA
GoCL	Goucher College, Julia Rogers Library, Baltimore MD
GonzUL	Gonzaga Univ. Library, Spokane WA
GriCL	Grinnell College, Burling Library, Grinnell IA
GroClL	The Grolier Club, New York NY
GrPL	Greenville Public Library, Greenville MS
GSUL	Georgia State Univ. Library, Atlanta GA
GTSL	General Theological Seminary, New York NY
GVSUL	Grand Valley State Univ., Seidman Library, Allendale MI
GWUL	George Washington Univ. Library, Washington DC
GWU(L)L	George Washington Univ. Law School, Jacob Burns Library, Washington DC
HaColL	Haverford College Library, Haverford PA
HamCL	Hamilton College Library, Clinton NY
HaPL	Hackley Public Library, Muskegon MI
Harv(AA)L	Harvard Univ., Arnold Arboretum, Jamaica Plain MA
Harv(BA)L	Harvard Univ., Kress Library of Business and Economics, Boston MA
Harv(Div)L	Harvard Univ., Divinity School, Andover-Harvard Theological Library, Cambridge MA
Harv(DO)L	Harvard Univ., Dumbarton Oaks Library, Washington DC
Harv(EB)L	Harvard Univ., Economic Botany Library of Oakes Ames, Cambridge MA
Harv(F)L	Harvard Univ., Fogg Art Museum, Cambridge MA
Harv(L)L	Harvard Univ., Law School Library, Cambridge MA
Harv(M)L	Harvard Univ., Francis A. Countway Library of Medicine, Boston MA
Harv(R)L	Harvard Univ., Radcliffe College Library, Cambridge MA
Harv(T)L	Harvard Univ., Berenson Library, I Tatti, Florence
Harv(Zoo)L	Harvard Univ., Museum of Comparative Zoology, Cambridge MA
HarvCL	Harvard College Library, Houghton Library, Cambridge MA
HAML	Houston Academy of Medicine - Texas Medical Center Library, Houston TX
HASL	Houston Academy of Science, Houston TX
HavPL	Haverhill Public Library, Haverhill MA
HEHL	The Huntington Library, San Marino CA
HFPRCL	Historical Foundation of the Presbyterian & Reformed Churches, Montreat NC
HL(B)	Claremont Colleges, Honnold Library (Bodman Coll.), Claremont CA
HL(H)	Claremont Colleges, Honnold Library (Hoover Coll.), Claremont CA
HL	Claremont Colleges, Honnold Library, Claremont CA
HNCL	Holy Name College, Washington DC
HolCL	Hollins Univ. Library, Roanoke VA
HPL	Houston Public Library, Houston TX
HSAL	Hispanic Society of America, New York NY
HSERCL	Historical Society of the Evangelical and Reformed Church, Lancaster PA
HSPaL	Historical Society of Pennsylvania, Philadelphia PA
HSTL	Harry S. Truman Library, Independence MO
HTML	Howard Tilton Memorial Library, Tulane Univ., New Orleans LA
HUCL	Hebrew Union College Library, Cincinnati OH
HUL	Hofstra Univ. Library, Hempstead NY
HyCAML	Hyde Collection Art Museum, Glens Falls NY
IllCL	Illinois College Library, Jacksonville IL
InPL	Indianapolis Public Library, Indianapolis IN
InSUL	Indiana State Univ., Terre Haute IN
InUL	Indiana Univ., The Lilly Library, Bloomington IN
IoSUL	Iowa State Univ., Ames IA
ISGML	Isabella Stewart Gardner Museum, Boston MA
ISTCL	Univ. of Northern Iowa, Cedar Falls IA
JCBL	Brown Univ., John Carter Brown Library, Providence RI
JCLor	Buffalo & Erie County Historical Society, John C. Lord Collection, Buffalo NY
JCUL	John Carroll Univ., Grasselli Library Library, University Heights OH
JFKL	John F. Kennedy Library, McCune Collection, Vallejo CA
JHSch	Scheide Library, Princeton Univ., Princeton NJ
JHU(F)L	Johns Hopkins Univ., The Laurence Hall Fowler Collection, Baltimore MD
JHU(W)L	Johns Hopkins Univ., William H. Welch Medical Library, Baltimore MD
JHUL	Johns Hopkins Univ. Library, Baltimore MD
JIRL	Hebrew Union College, Jewish Institute of Religion, New York NY
JMCL	Thomas Jefferson Univ. Library, Philadelphia PA
JTSL	Jewish Theological Seminary of America, New York NY
JunCL	Juniata College Library, Huntingdon PA
JWGL	Johns Hopkins Univ., John Work Garrett Library, Baltimore MD
KalCL	Kalamazoo College, Kalamazoo MI
KenCL	Kenyon College Library, Gambier OH
KenSL	Kenrick-Glennon Seminary Library, St Louis MO
KenSUL	Kent State Univ. Library, Kent OH
KnCL	Knox College Library, Galesburg IL
KSUL	Kansas State Univ. Library, Manhattan KS
LaCL	Lafayette College, Van Wickle Library, Easton PA
LACLL	Los Angeles County Law Library, Los Angeles CA
LakePL	Lakeside Press, Chicago IL
LanTSL	Lancaster Theological Seminary, Lancaster PA
LAPL	Los Angeles Public Library, Los Angeles CA
LaSUL	Louisiana State Univ. Library, Baton Rouge LA
LaSUSL	Louisiana State Univ., James Smith Noel Library, Shreveport LA
LC	Library of Congress, Rare Book Division, Washington DC
LC(B)	Library of Congress, John Davis Batchelder Collection, Washington DC
LC(L)	Library of Congress, Law Library, Washington DC
LC(M)	Library of Congress, Music Division, Washington DC
LC(R)	Library of Congress, Lessing J. Rosenwald Collection, Washington DC
LC(T)	Library of Congress, John Boyd Thacher Collection, Washington DC
LCPhL	Library Company of Philadelphia, Philadelphia PA
LeUL	Lehigh Univ. Library, Bethlehem PA
LIHSL	Brooklyn Historical Society, Brooklyn NY
LindHL	Linda Hall Library, Kansas City MO
LinUL	Lincoln Univ., Vail Memorial Library, Lincoln Univ. PA
LLandML	Lloyd Library & Museum, Cincinnati OH
LorCL	Loras College Library, Dubuque IA
LoyMUL	Loyola Marymount Univ. Library, Los Angeles CA
LoyU(NO)L	Loyola Univ. Library, New Orleans LA
LoyUL	Loyola Univ., E.M. Cudahy Memorial Library, Chicago IL
LTL	Lancaster Town Library, Lancaster MA
LTS(G)L	Lutheran Theological Seminary, Gettysburg PA
LTSL	Lutheran Theological Seminary, Krauth Memorial Library, Philadelphia PA
LuCL	Luther College Library, Decorah IA
LuSL	Luther Seminary Library, St Paul MN
LyPL	Lynn Public Library, Lynn MA
ManCL	Manhattan College, New York NY
MarCL	Marietta College, Marietta OH
MarqUL	Marquette Univ., Raynor Library, Milwaukee WI
MBGL	Missouri Botanical Garden, St Louis MO
MCFMdL	Medical and Chirurgical Faculty of the State of Maryland, Baltimore MD
MCL	Macalester College Library, St Paul MN
MCSHL	Manhattanville College Library, Purchase NY
McTSL	Jesuit-Krauss-McCormick Library, Chicago IL
MedCWL	Medical College of Wisconsin Library, Milwaukee WI
MEEIL	Massachusetts Eye & Ear Infirmary, Boston MA
MenFL	Menninger Foundation, Topeka KS
MerL	Mercantile Library, Philadelphia PA
MFArtL	Museum of Fine Arts, Dept. of Prints, Drawings, and Photographs, Boston MA
MHSL	Massachusetts Historical Society, Boston MA
MiCL	Middlebury College, Middlebury VT
MiL	Library of Michigan, Lansing MI
MilCL	Mills College, Oakland CA
MilPL	Milwaukee Public Library, Milwaukee WI
MiPL	Minneapolis Public Library, Minneapolis MN
MiSUL	Michigan State Univ., East Lansing MI
MITL	Massachusetts Institute of Technology,, Cambridge MA
MiUL	Miami Univ. Library, Oxford OH
MLuColL	Martin Luther College Library, New Ulm MN
MMu(P)L	Metropolitan Museum of Art, Department of Prints, New York NY
MMuL	Metropolitan Museum of Art Library, New York NY
MorAL	Morton Arboretum Library, Lisle IL
MorArch	Moravian Archives, Bethlehem PA
MSML	Mt. Saviour Monastery, Pine City NY
MtAL	Mt. Angel Abbey, St Benedict OR
MtHCL	Mt. Holyoke College, South Hadley MA
MtSAL	Mt. St Alphonsus Seminary, Esopus NY
MtSML	Mt. St Mary's Univ., Emmitsburg MD
MuhlCL	Muhlenberg College, Allentown PA
MulCoCL	Multnomah County Central Library, Portland OR
NavAcL	U.S. Naval Academy, Annapolis MD
NavObL	U.S. Naval Observatory, Washington DC
NBPL	New Bedford Free Public Library, New Bedford MA
NBWM	New Bedford Whaling Museum, New Bedford MA
NewaPL	Newark Public Library, Newark NJ
NewL	The Newberry Library, Chicago IL
NGA(R)	National Gallery of Art, Lessing J. Rosenwald Coll., Washington DC
NGA(W)	National Gallery of Art, Ian G. Woodner Collection, Washington DC
NGSL	National Geographic Society, Washington DC
NHStL	New Hampshire State Library, Concord NH
NiUL	Niagara Univ. Library, Niagara NY
NLM	National Library of Medicine, Bethesda MD
NOBTSL	New Orleans Baptist Theological Seminary, John T. Christian Library, New Orleans LA
N(SCh)L	Sisters of Charity of Nazareth Library, Nazareth KY
NwUL	Northwestern Univ. Library, Evanston IL
NwU(L)L	Northwestern Univ., School of Law, Elbert H. Gary Library, Chicago IL
NwU(M)L	Northwestern Univ., Galter Health Sciences Library, Chicago IL
NYAcMedL	New York Academy of Medicine, New York NY
NYBoGL	New York Botanical Garden, New York NY
NYHisSL	New York Historical Society, New York NY
NYLawIL	New York Law Institute, New York NY
NYPIL	New York State Psychiatric Institute Library, Columbia Presbyterian Medical Center, New York NY
NYPL	New York Public Library, Rare Book Division, New York NY
NYPL(B)	New York Public Library, Berg Collection, New York NY
NYPL(D)	New York Public Library, Drexel Collection, New York NY
NYPL(J)	New York Public Library, Jewish Division, New York NY
NYPL(P)	New York Public Library, Parsons Collection, New York NY
NYPL(S)	New York Public Library, Spencer Collection, New York NY
NYPL(St)	New York Public Library, Stuart Collection, New York NY
NYSL	New York Society Library, New York NY
NYStL	New York State Library, Albany NY
NYT(Ex)L	New York Times, Exhibit of the Recorded Word, New York NY
NYU(H)L	New York Univ., Univ. Heights Library, New York NY
NYU(W)L	New York Univ., Washington Square, New York NY
ObCL	Oberlin College Library, Oberlin OH
OcCL	Occidental College, Los Angeles CA
OclGC	Garden Center, Cleveland OH
OCPL	Onondaga County Public Library, Syracuse NY
ODL	Oscar Diethelm Library, New York NY
OhStUL	Ohio State Univ. Libraries, Columbus OH
OhWUL	Ohio Wesleyan Univ. Library, Delaware OH
OkStUL	Oklahoma State Univ. Library, Stillwater OK
OmeH	Holden Arboretum, Mentor OH
OSGL	Oak Spring Garden Library, Upperville VA
OSUL	Oregon State Univ., Corvallis OR
PacUL	Pacific Univ. Library, Forest Grove OR
PaHL	Pennsylvania Hospital Library, Philadelphia PA
PCL	Providence College Library, Providence RI
PedSL	The Peddie School, Highstown NJ
PeqL	Pequot Library, Yale Univ. Library, New Haven CT
PExAcL	Phillips Exeter Academy, Exeter NH
PhAcL	Phillips Academy, Oliver Wendell Holmes Library, Andover MA
PhFL	Free Library of Philadelphia, Philadelphia PA
PhF(W)L	Free Library of Philadelphia, Copinger-Widener Collection, Philadelphia PA
PittTSL	Pittsburgh Theological Seminary Library, Pittsburgh PA
PML	Pierpont Morgan Library, New York NY
PonCJL	Pontifical College Josephinum, Worthington OH
PPTJL	T.F. Jenkins Memorial Law Library, Philadelphia PA
PrAthL	Providence Athenaeum, Providence RI
PratIL	Pratt Institute Library, Brooklyn NY
PrinTSL	Princeton Theological Seminary, Speer Library, Princeton NJ
PrinUL	Princeton Univ., Firestone Library, Princeton NJ
PrinU(A)L	Princeton Univ., Art Museum, Princeton NJ
ProvPL	Providence Public Library, Providence RI
PStL	State Library of Pennsylvania, Harrisburg PA
PStUL	Pennsylvania State Univ., University Park PA
QCL	Quincy Univ., Quincy IL
RbergL	Rosenberg Library, Galveston TX
RCL	Rowfant Club, Cleveland OH
RedwL	Redwood Library and Athenaeum, Newport RI
RISDL	Rhode Island School of Design, Providence RI
RITL	Rochester Institute of Technology, Rochester NY
RivPL	Riverside Public Library, Riverside CA
R-MCL	Randolph-Macon Woman's College, Lynchburg VA
RosML	Rosenbach Museum & Library, Philadelphia PA
RossHSL	Ross County Historical Society, Chillicothe OH
RUL	Rice Univ., Houston TX
RutgUL	Rutgers Univ. Library, New Brunswick NJ
SanAPL	San Antonio Public Library, San Antonio TX
SBCL	St Basil College, Stamford CT
SchwHL	Schwenkfelder Historical Library, Pennsburg PA
SCJL	Spertus Institute of Jewish Studies, Chicago IL
SCML	Supreme Court of Missouri, Library, Jefferson City MO
ScrCL	Scripps College, Denison Library, Claremont CA
SDPL	San Diego Public Library, Wangenheim Collection, San Diego CA
SDSUL	San Diego State Univ., Malcolm A. Love Library, San Diego CA
SeHCL	Seton Hill College, Greensburg PA
SFPL	San Francisco Public Library, San Francisco CA
SFSUL	San Francisco State Univ. Library, San Francisco CA
SHFL	Salisbury House Foundation Library, Des Moines IA
SHSTL	Sacred Heart School of Theology, Hales Corners WI
SiLCL	Silver Lake College Library, Manitowoc WI
SkCL	Skidmore College, Lucy Scribner Library, Saratoga Springs NY
SLL	Social Law Library, Boston MA
SLPL	St Louis Public Library, St Louis MO
Sm(CH)L	Smithsonian Institution, Cooper-Hewitt, National Design Museum, New York NY
Sm(D)L	Smithsonian Institution, Dibner Library of the History of Science & Technology, Washington DC
SmCL	Smith College, Northampton MA
SmI(GA)L	Smithsonian Institution, National Museum of American History, Washington DC
SoIllUL	Southern Illinois Univ., Carbondale IL
SoMeth(B)UL	Southern Methodist Univ., Bridwell Library, Dallas TX
SoMeth(G)UL	Southern Methodist Univ., de Golyer Library, Dallas TX
SpPL	Spokane Public Library, Spokane WA
SprCL	Springfield Library, Springfield MA
StAlL	St Albans National Cathedral School for Boys, Washington DC
StanU(M)L	Stanford Univ. Medical Center, Lane Medical Library, Stanford CA
StanUL	Stanford Univ. Library, Stanford CA
StAPL	St Anselm's Abbey, Washington DC
StBenCL	Benedictine College, Atchison KS
StBerCL	St Bernard Junior College, St Bernard AL
StBonUL	St Bonaventure Univ., Friedsam Memorial Library, St Bonaventure NY
StChS(C)L	St Charles Seminary Library, Carthagena OH
StChSL	St Charles Borromeo Seminary Library, Wynnewood PA
StFC(L)L	St Francis College, Loretto PA
StFSL	St Francis Seminary, St Francis WI
StHSL	St Hyacinth College and Seminary, Granby MA
StJCL	St John's College, Annapolis MD
StJnSL	St John's Seminary, Creagh Research Library, Brighton MA
StJ(NY)UL	St John's Univ. Library, Queens NY
StJSL	St Joseph's Seminary, Yonkers NY
StJUL	St John's Univ. Library, Hill Museum & Manuscript Library, Collegeville MN
StLML	St Louis Mercantile Library, St Louis MO
StLouUL	St Louis Univ., Pius XII Memorial Library, St Louis MO
StLouU(L)L	St Louis Univ., Law Library, St Louis MO
StLUL	St Lawrence Univ. Library, Canton NY
StM(B)L	St Mary's Seminary & Univ., Baltimore MD
StM(P)L	St Mary's Seminary, Perryville MO
StMC(X)L	University of St Mary, De Paul Library, Leavenworth KS
StMeinAL	St Meinrad Archabbey, Library, St Meinrad IN
StMiCL	St Michael's College, Colchester VT
StMLSL	Univ. of St Mary of the Lake, Mundelein Seminary, Feehan Memorial Library, Mundelein IL
StOCL	St Olaf College, Northfield MN
StPatSL	St Patrick's Seminary, Menlo Park CA
StPML	St Paul of the Cross Monastery, Pittsburgh PA
StPSL	St Paul's School, Concord NH
StVAL	St Vincent College & Archabbey Library, Latrobe PA
SUNY(B)L	State Univ. of New York at Binghamton, Binghamton NY
SusUL	Susquehanna Univ. Library, Selinsgrove PA
S-WeTSL	Seabury-Western Theological Seminary, Evanston IL
SwML	Southwest Museum, Los Angeles CA
SyrUL	Syracuse Univ. Library, Syracuse NY
TBML	Spring Hill College, Thomas Byrne Memorial Library, Mobile AL
TCL	Thiel College Library, Greenville PA
TemUL	Temple Univ. Library, Philadelphia PA
TexAMUL	Texas A&M Univ., Cushing Memorial Library, College Station TX
TexCUL	Texas Christian Univ., Mary Couts Burnett Library, Fort Worth TX
ThSL	New Brunswick Theological Seminary, New Brunswick NJ
TolMAL	Toledo Museum of Art, Toledo OH
TransUL	Transylvania Univ. Library, Lexington KY
TrinC(W)L	Trinity College Library, Washington DC
TrinUL	Trinity Univ. Library, San Antonio TX
TTUL	Texas Tech Univ. Library, Lubbock TX
TuUL	Tufts Univ. Library, Medford MA
UAlaBL	Univ. of Alabama Medical Center, Reynolds Historical Library, Birmingham AL
UAlaL	Univ. of Alabama, Tuscaloosa AL
UArkL	Univ. of Arkansas, Fayetteville AR
UBufL	State Univ. of New York at Buffalo, Buffalo NY
UCalB(L)L	Univ. of California, Law Library, Berkeley CA
UCalB(M)L	Univ. of California, Music Library, Berkeley CA
UCalBL	Univ. of California, Bancroft Library, Berkeley CA
UCalDL	Univ. of California, Shields Library, Davis CA
UCalIL	Univ. of California, Irvine CA
UCalLAL	Univ. of California at Los Angeles, Los Angeles CA
UCalLA(B)L	Univ. of California at Los Angeles, Belt Library of Vinciana, Los Angeles CA
UCalLA(M)L	Univ. of California at Los Angeles, Biomedical Library, Los Angeles CA
UCalRL	Univ. of California, Riverside CA
UCalS(M)L	Univ. of California, Medical Center, San Francisco CA
UCalSBL	Univ. of California, Santa Barbara CA
UCalSDL	Univ. of California, San Diego CA
UChiL	Univ. of Chicago Libraries, Chicago IL
UCinL	Univ. of Cincinnati, Cincinnati OH
UCin(M)L	Univ. of Cincinnati, Cincinnati Medical Heritage Library, Cincinnati OH
UColoL	Univ. of Colorado Libraries, Boulder CO
UDelL	Univ. of Delaware, Newark DE
UDenL	Univ. of Denver Libraries, Denver CO
UFlaL	Univ. of Florida Libraries, Gainesville FL
UGeoL	Univ. of Georgia, Hargrett Library, Athens GA
UHouL	Univ. of Houston, Houston TX
UIdL	Univ. of Idaho, Moscow ID
UIllCL	Univ. of Illinois at Chicago, Main Library, Chicago IL
UIll(E)L	Univ. of Illinois, Museum of European Culture, Urbana IL
UIllL	Univ. of Illinois at Urbana-Champaign Library, Urbana IL
UIoL	Univ. of Iowa, The Univ. Libraries, Iowa City IA
UKan(M)L	Univ. of Kansas Medical Center, Clendining Library, Kansas City KS
UKanL	Univ. of Kansas, Spencer Library, Lawrence KS
UKyL	Univ. of Kentucky, Margaret I. King Library, Lexington KY
ULouL	Univ. of Louisville, Ekstrom Library, Louisville KY
UMaryBL	Univ. of Maryland, Health Sciences & Human Services Library, Baltimore MD
UMiamL	Univ. of Miami Library, Coral Gables FL
UMiam(M)L	Univ. of Miami School of Medicine, Bascom Palmer Eye Institute Library, Miami FL
UMich(L)L	Univ. of Michigan, The Law Library, Ann Arbor MI
UMich(S)L	Univ. of Michigan, Stephen Spaulding Collection, Ann Arbor MI
UMichL	Univ. of Michigan, Univ. Library, Ann Arbor MI
UMinL	Univ. of Minnesota, The Univ. Library, Minneapolis MN
UMin(B)L	Univ. of Minnesota, James Ford Bell Library, Minneapolis MN
UMinDL	Univ. of Minnesota, Ramseyer-Northern Bible Society Coll., Duluth MN
UMin(L)L	Univ. of Minnesota Law Library, Minneapolis MN
UMin(W)L	Univ. of Minnesota, Wangensteen Library, Minneapolis MN
UMisL	Univ. of Missouri, Columbia MO
UMisKCL	Univ. of Missouri, Kansas City MO
UMissL	Univ. of Mississippi, University MS
UNCaCL	Univ. of North Carolina Library, Charlotte NC
UNCaL	Univ. of North Carolina Library, Chapel Hill NC
UnCL	Union College, Schenectady NY
UNDamL	Univ. of Notre Dame, The Univ. Library, Notre Dame IN
UNebL	Univ. of Nebraska, The Univ. Libraries, Lincoln NE
UNeb(M)L	Univ. of Nebraska Medical Center, McGoogan Library, Omaha NE
UNevL	Univ. of Nevada, Reno NV
UNHL	Univ. of New Hampshire, Durham NH
UNoFlaL	Univ. of North Florida, Jacksonville FL
UNTexL	Univ. of North Texas, Willis Library, Denton TX
UnTS(V)L	Union Theological Seminary Library, Richmond VA
UnTSL	Union Theological Seminary, Burke Library, New York NY
UOkL	Univ. of Oklahoma Libraries, Norman OK
UOreL	Univ. of Oregon Library, Eugene OR
UPaL	Univ. of Pennsylvania, Van Pelt Library, Philadelphia PA
UPa(B)L	Univ. of Pennsylvania, Botany Library, Philadelphia PA
UPa(F)L	Univ. of Pennsylvania, Furness Library, Philadelphia PA
UPa(J)L	Univ. of Pennsylvania, Center for Advanced Judaic Studies, Philadelphia PA
UPa(L)L	Univ. of Pennsylvania, Biddle Law Library, Philadelphia PA
UPa(Lea)L	Univ. of Pennsylvania, Lea Library, Philadelphia PA
UPa(S)L	Univ. of Pennsylvania, Edgar Fahs Smith Collection, Philadelphia PA
UPa(Y)L	Univ. of Pennsylvania, Yarnall Collection, Van Pelt Library, Philadelphia PA
UPittL	Univ. of Pittsburgh Library, Pittsburgh PA
UPitt(F)L	Univ. of Pittsburgh, Maurice and Laura Falk Library of the Health Professions, Pittsburgh PA
UPRicoL	Univ. of Puerto Rico, Rio Piedras PR
URo(M)L	Univ. of Rochester Medical Center, Edward G. Miner Library, Rochester NY
URo(S)L	Univ. of Rochester, Sibley Music Library, Eastman School of Music, Rochester NY
URoL	Univ. of Rochester, Rush Rhees Library, Rochester NY
USA(C)L	U.S. Army War College, Military History Institute, Carlisle Barracks, Carlisle PA
USAFAL	U.S. Air Force Academy Library, USAF Academy CO
UScranL	Univ. of Scranton, Scranton PA
USFL	Univ. of San Francisco, Gleeson Library, San Francisco CA
USIUL	U.S. International Univ., San Diego CA
USoCalL	Univ. of Southern California, Univ. Library, Los Angeles CA
USoCarL	Univ. of South Carolina, Thomas Cooper Library, Columbia SC
USoFlaL	Univ. of South Florida, Tampa FL
USoL	The Univ. of the South Library, Sewanee TN
USoMaiL	Univ. of Southern Maine, Osher Map Library, Portland ME
USSCL	U.S. Supreme Court Library, Washington DC
UStTL	Univ. of St Thomas, Houston TX
UTenL	Univ. of Tennessee, Knoxville TN
UTex(M)L	Univ. of Texas Medical Branch, Moody Medical Library, Galveston TX
UTexL	Univ. of Texas at Austin, Harry Ransom Humanities Research Center, Austin TX
UTex(L)L	Univ. of Texas School of Law, Tarlton Law Library, Austin TX
UUtL	Univ. of Utah, J. Willard Marriott Library, Salt Lake City UT
UVa(M)L	Univ. of Virginia, Health Sciences Library, Charlottesville VA
UVa(Mc)L	Univ. of Virginia, McGregor Library, Charlottesville VA
UVaL	Univ. of Virginia, Alderman Library, Charlottesville VA
UVerL	Univ. of Vermont, The Univ. Library, Burlington VT
UWashL	Univ. of Washington Library, Seattle WA
UWash(H)L	Univ. of Washington, Health Sciences Library, Seattle WA
UWash(L)L	Univ. of Washington, Law Library`, Seattle WA
UWis(AGS)L	Univ. of Wisconsin-Milwaukee, American Geographical Society Library, Milwaukee WI
UWis(M)L	Univ. of Wisconsin, Middleton Medical Library, Madison WI
UWis(Mil)L	Univ. of Wisconsin-Milwaukee, Milwaukee WI
UWisL	Univ. of Wisconsin, Madison WI
UWyoL	Univ. of Wyoming, Toppan Rare Books Library, Laramie WY
VanUL	Vanderbilt Univ., Nashville TN
VasCL	Vassar College, Poughkeepsie NY
VaSL	Library of Virginia, Richmond VA
VilUL	Villanova Univ. Library, Villanova PA
VinOCathL	Vincennes Old Cathedral, Vincennes IN
WACML	Univ. of California, William Andrews Clark Memorial Library, Los Angeles CA
WandJCL	Washington & Jefferson College, Washington PA
WandLUL	Washington and Lee Univ., Lexington KY
WandMCL	William and Mary College, Swem Library, Williamsburg VA
WArtGL	Walters Art Gallery, Baltimore MD
WarTSL	Wartburg Theological Seminary, Dubuque IA
WaSUL	Wayne State Univ., Univ. Libraries, Detroit MI
WatkL	Trinity College, Watkinson Library, Hartford CT
WaUL	Washington Univ. Libraries, St Louis MO
WaU(L)L	Washington Univ., School of Law, St Louis MO
WaU(M)L	Washington Univ., School of Medicine, St Louis MO
WCaL	Washington Cathedral Library, Washington DC
WdCL	Georgetown Univ., Woodstock Theological Center Library, Washington DC
WeBL	National Oceanic & Atmospheric Administration Central Library, Silver Spring MD
WellCL	Wellesley College Library, Wellesley MA
WellsCL	Wells College Library, Aurora NY
WesUL	Wesleyan Univ. Library, Middletown CT
WillCL	Williams College Library, Williamstown MA
WillUL	Willamette Univ. Library, Salem OR
WiSUL	Wichita State Univ. Library, Wichita KS
WittUL	Univ. of Cincinnati, Cincinnati OH
WJeCL	Univ. of Cincinnati, Cincinnati Medical Heritage Library, Cincinnati OH
WLCleL	Univ. of Michigan, William L. Clements Library, Ann Arbor MI
WMU(C)L	Western Michigan Univ., Inst. of Cistercian Studies, Kalamazoo MI
WobPL	Woburn Public Library, Woburn MA
WorFPL	Free Public Library, Worcester MA
WorHSL	Worcester Historical Society, Worcester MA
WPtL	U.S. Military Academy, West Point NY
WResHSL	Western Reserve Historical Society, Cleveland OH
WResUL	Case Western Reserve Univ. Libraries, Cleveland OH
WStCL	Washington State Univ., Pullman WA
WVUL	West Virginia Univ., Morgantown WV
XavUL	Xavier Univ. Library, Cincinnati OH
YesUL	Yeshiva Univ. Library, New York NY
YU(A)L	Yale Univ., School of the Fine Arts, New Haven CT
YU(B)L	Yale Univ., Centre for British Art, New Haven CT
YUL	Yale Univ., Beinecke Library, New Haven CT
YU(L)L	Yale Univ., Law School Library, New Haven CT
YU(M)L	Yale Univ., Historical Library of the Medical School, New Haven CT
YU(Mus)L	Yale Univ., Music School, New Haven CT
YU(T)L	Yale Univ., Beinecke Library, Henry C. Taylor Collection, New Haven CT
ZReL	Zion Research Library, Brookline MA
AAHj	Arthur A. Houghton Jr., Queenstown MD
ACH	Anna C. Hoyt, Brookline MA
AD	Albert Doezema, Grand Rapids MI
AES	A.E. Skinner, Austin TX
AEV	Arthur E. Vershbow, Newton Centre MA
AHR	Arthur H. Raynolds, M.D., New York NY
AJB	Alfred J. Brown, M.D., Omaha NE
ALCas	Mrs Alfred L. Castle, Honolulu HI
ALdR	A. Luini del Russo, M.D., Silver Spring MD
ALG	Arthur L. Gale, New York NY
ALGab	Astrik L. Gabriel, Notre Dame IN
AMG	Albert M. Grier, Larchmont PA
AMH	Alfred M. Hellmann, M.D., New York NY
AMTu	Albert Morton Turner, Orono ME
AP	Arne Pettersen, Tuckahoe NY
APR	Mrs. Alexander P. Rosenberg, New York NY
APS	A.P. Smith, Miami FL
APSy	Albert Philip Sy, Buffalo NY
ASKB	Anne S.K. Brown, Providence RI
BG	Ben Grauer, New York NY
BGO	B.G. Odescalchi
BLU	Berthold L. Ullman, Chapel Hill NC
BMar	Benedict Markowski, Detroit MI
BPen	Boies Penrose, Devon PA
BRD	Ben R. Donaldson, Detroit MI
CAF	Charles A. Foster, Washington DC
CAM	Cyril A. Mango, Washington DC
CCR	Charles C. Ryrie, Dallas TX
CDH	Charles D. Humberd, M.D., Barnard MO
CDHP	C. Doris Hellman Pepper (Mrs. Morton Pepper), New York NY
CERj	Charles E. Roseman, Jr., Cleveland Heights OH
CGA	C.G. Anthon, Washington DC
CHMcM	C.H. McMullen, Bloomington IN
CJ	Campbell Jones, Washington DC
CJR	Charles J. Rosenbloom, Pittsburgh PA
CLea	Chauncy D. Leake, Columbus OH
CSS	Clara S. Strassburger (Mrs. Irwin Strassburger) White Plains NY
CTC	C. Templeton Crocker, Estate of, San Francisco CA
CWA	Charles W. Andrews, Syracuse NY
CWH	C. Wesley Hallett, Flushing NY
DB	Davenport Brown, Boston MA
DBor	David Borowitz, Chicago IL
DDW	Rev. D.D. Wagner, Baltimore OH
DHHF	David H.H. Felix, Philadelphia PA
DHW	Donald H. Williams, Kensington MD
DJMcW	David Jackson McWilliams, San Juan PR
DK	David Kaiser, St Louis MO
DRo	D. Rome, Seattle WA
EandLB	Esther & Leonard Baskin, Northampton MA
EB	Edwin Bachmann, New York NY
EBK	Edward B. Krumbhaar, M.D., Philadelphia PA
EBS	Elizabeth B. Steere, Ann Arbor MI
EC	Eleanor Carey (Mrs W. Gibson Carey), Greenwich CT
EFH	Estate of Emmet Field Horine, M.D., Brooks KY
EHC	E.H. Cushing, M.D., Washington DC
EHLS	Eric H.L. Sexton, Rockport ME
EHWi	Ernest H. Wilkins, Newton Centre MA
EHZ	Edwin H. Zeydel, Cincinnati OH
EJM	Rev. E.J. Mahnke, Minneapolis MN
ELMjandGM	Edward L. McAdam, Jr. & George Milne, New York NY
EOG	Edwin Osgood Grover, Winter Park FL
ESO	Edgar S. Oppenheimer, New York NY
EWd	Eunice Wead, Ann Arbor MI
FCBj	F.C. Benson, Jr., M.D., Philadelphia PA
FDC	Frank D. Crane, Madison WI
FEW	Florence E. Wall, New York NY
FFR	Francis F. Randolph, New York NY
FJj	Brian Johnson, Portland OR
FJS	Francis J., Cardinal Spellman, New York NY
FK	Francis Kettaneh, New York NY
FM	Foster Mohrhardt, Arlington VA
FMcG	F. McGraw, Overland Park KS
FMR	Frances M. Rogge, Toledo OH
FPj	Frederick Pope, Jr, Fairfield CT
FPJon	Franklin P. Jones, Bennington VT
FPL	Frank P. Leslie, Minneapolis, MN
FRG	Frederick R. Goff, Washington DC
FVdeB	Frank V. de Bellis, San Francisco CA
FWA	Frederick W. Allsopp, Little Rock AR
GB	G. Bechtel, Chevy Chase MD
GH	Gilbert Highet, New York NY
GLHo	George L. Howe, Fulton MD
GU	Giogio Uzielli, New York NY
GWJ	Gordon W. Jones, M.D., Falmouth VA
HAWj	Harry A. Walton, Jr, Covington VA
HBF	Henry B. Fernald, Upper Montclair NJ
HBLin	Harriet B. Lincoln, Worcester MA
HBM	H. Bradley Martin, New York NY
HC	H. Cahoon, New York NY
HDC	Homer D. Crotty, San Marino CA
HDCo	Harris Dunscombe Colt, Washington DC
HG	H. Grunder, Williamsburg VA
HH	Herbert Howe, Madison WI
HHu	Harold Hugo, Meriden CT
HLam	Harold Lamb, Beverly Hills CA
HN	Harold Null, Grand Island NE
HRA	H.R. Archer, Williamstown MA
HS	Lt Col. Helmuth Sorinz, Washington DC
HSB	Helen Safford Bonnell, Philadelphia PA
HWe	Hollis Webster, Lexington MA
IR	Isaac Rivkind M.D., New York NY
IS	Irving Sporn M.D., Portland ME
JBD	J.B. Doukas, Kalamazoo MI
JBP	Rev. J. Bradford Pengelly, Oak Park IL
JCH	John C. Hirsch, Washington, DC
JDS	J.D. Stantz, M.D., University Heights OH
JG	Rev. James Griffith, Brooklyn NY
JGB	J.G. Brodie, Greenfield NH
JGT	Justin G. Turner, Los Angeles CA
JGVD	James Grote VanDerpool, New York NY
JHN	John H. Northup, Niagara Falls NY
JHPer	James H. Pershing, Denver CO
JIE	J.I. Edison, St Louis MO
JJBL	John J.B. Light, M.D., Lebanon PA
JJF	Jean J. Fox, Chicago IL
JLH	John Louis Haney, Philadelphia PA
JLW	James L. Weygand, Nappanee IN
JMCj	John M. Crawford, Jr., New York NY
JO	J. Onderwyzer, New York NY
JPB	Rev. Joseph P. Bartak, Savannah GA
JRS	John Rothwell Slater, Rochester NY
JS	John Slocum, Newport RI
JSF	J.S. Fuchs, New York NY
JTB	John T. Bancroft, Sandy Spring MD
JWDH	Josephine W. Drexel Henry, Andalusia PA
JWo	Julian Wolff, M.D., New York NY
JWP	Mrs J. Wallace Paletou, New Orleans LA
KS	Kenneth Schott, New Haven CT
LEG	Lee Edmonds Grove, Washington DC
LLM	L.L. Marton, Washington DC
MCW	M.C. Wahl, Baltimore MD
MD	Myron Davey, Lorton VA
MDB	Maryone D. Barlow, New York NY
MDV	Marie D. Vernon, Reading PA
MEC	M.E. Crahan, M.D., Los Angeles CA
MFR	Margaret F. Rudkin, Fairfield CT
MFRu	Milton F. RÃºa, Santurce PR
MHS	Morris H. Saffron, M.D., Passaic NJ
MMZ	Michael M. Zagayski, New York NY
MNB	M.N. Beigelman, Los Angeles CA
MP	M. Pollak, Dallas TX
MSC	Mary S. Collins, Estate of, Wyncote PA
MSdeG	Mercedes S. de Gomez, Yeadon PA
MSG	M.S. Goldman, Urbana IL
NC	Nelson Coon, Watertown MA
NCS	N.C. Starr, New York NY
NHS	Norman H. Strouse, New York NY
NJN	N.J. Nakles, Latrobe PA
NPH	Norman P. Henderson, Heath MA
OFE	Mrs Otto F. Ege, Cleveland OH
OLW	Oscar L. Watkins, Indianapolis IN
OOF	O.O. Fischer, M.D., Estate of, Detroit MI
OWF	Otto W. Fuhrmann, Elmhurst NY
PandJG	Collection of the late Phyllis and John Gordan, New York NY
PFG	P.F. Grendler, Chapel Hill NC
PH	Philip Hofer, Cambridge MA
PM	Paul Mellon, Upperville VA
PO	P. Oliver, Estate of, Mount Kisco NY
PWH	Philip W. Harsh, Stanford CA
PWS	Philip W. Schulte, Silver Spring MD
RAB	Redmond A. Burke, C.S.V., Chicago IL
RBB	Robert B. Brown, Ann Arbor MI
RBL	Ronald B. Levinson, Orono ME
RBvKS	Rufus B. von Klein-Smid, Estate of, Los Angeles CA
RD	R. Dechert, King of Prussia PA
RE	Raphael Esmerian, New York NY
REH	Raymond E. Hartz, Madison NJ
RF	Roland Folter, New York NY
RFL	R.F. Lane, Copiague NY
RHB	Mr & Mrs R.H. Behrens, Bethesda MD
RJD	Ruth J. Dean, South Hadley MA
RLBT	Robert L.B. Tobin, San Antonio TX
RM	Robert Moes M.D., Los Angeles CA
RMF	Richard M. Fichel, Meadowbrook, PA
RMR	Rodney M. Rudd, Cleveland OH
RP	Richard Priest, New York NY
RQK	Robert Q. Kelly, Chicago IL
RS	Robin Satinsky, Villanova PA
RTM	Robert T. Meyer, Gaithersburg MD
RVS	Mrs Rose Victor Stroly, Woodmere, Long Island NY
RWB	Robert Warwick Bingham, Buffalo NY
RWM	Robert Walsingham Martin, Estate of, New Rochelle NY
SBH	Mrs Samuel B. Hemingway, New Haven CT
SBS	S.B. Schimmel, New York NY
SH	Sinclair Hamilton, New York NY
SHT	Samuel Harrison Thomson, Boulder CO
SI	S. Ives, Cambridge MA
STMj	Mrs S.T. Miller, Jr, Grosse Pointe Farms MI
SXR	Samuel X. Radbill, Philadelphia PA
TAK	Thomas A. Kirby, Baton Rouge LA
TEM	Thomas E. Marston, New Haven CT
TGH	Tyrus G. Harmsen, Pasadena CA
TKB	T. Kimball Brooker, New York NY
TOM	Thomas O. Mabbott, New York NY
TRA	Thomas R. Adams, Providence RI
TS	T. Smithey, Taylor MI
VBG	Mrs Virginia Boyd Goult, Chicago IL
VdeG	Victor de Guinzbourg, New York NY
VK	Van Kampen Collection, Orlando FL
WAD	William A. Didier, Fort Wayne IN
WBB	Mrs. Walter B. Beals, Olympia WA
WBE	Capt. William B. Edelman, Fairfax VA
WBS	Walter B. Sheppard, Denver CO
WCB	William C. Beck, M.D., Waverly NY
WCW	Wesley C. Williams, Gates Mills OH
WDM	William D. Morgan, St Paul MN
WDMer	Walter D. Merwin, Clarence Center, NY
WELo	W. Easton Louttit, Jr., Providence RI
WGL	William G. Lennox, M.D., Boston MA
WMIj	William M. Ivins, Jr., Estate of, Woodbury CT
WR	Ward Ritchie, Los Angeles CA
WS	Wladimir Seidel, Notre Dame IN
WSG	William S. Glazier, Estate of, New York NY
WV	Willis Van Devanter, Upperville VA
WW	Webb Woodward, Tucson AR
WY	Winona Young, Chicago IL
